азбука - Средство начального обучения {Средство} 	 type:NAN
алоэ - растение семейства лилейных {растение} 	 type:NNA 
альянс - Объединение отдельных лиц {Объединение} 	 type:NAN
амнистия - снятие судебного наказания {снятие} 	 type:NAN
архиерей - Священнослужитель высшей (3-й {Священнослужитель} 	 type:NAN
безделье - Отсутствие полезного дела {Отсутствие} 	 type:NAN
бездушие - Отсутствие душевной теплоты {Отсутствие} 	 type:NAN
безнравственность - Отсутствие нравственных устоев {Отсутствие} 	 type:NAN
бережливость - Качество человека осторожного {Качество} 	 type:NNA 
беспокойство - Состояние нервного возбуждения {Состояние} 	 type:NAN
беспорядочный - логических связей стройности {связей} 	 type:ANN 
библия - Собрание священных книг {Собрание} 	 type:NAN
благотворительность - Оказание материальной помощи {Оказание} 	 type:NAN
бог - объект религиозной веры {объект} 	 type:NAN
богатство - Состояние хозяйства финансовых дел {Состояние} 	 type:NNAN 
божница - Предмет религиозного быта {Предмет} 	 type:NAN
бокал - Сосуд из стекла {Сосуд} 	 type:NPN
болезнь - Нарушение нормальной жизнедеятельности {Нарушение} 	 type:NAN
бомбардировка - удары авиации ракетных установок {удары} 	 type:NNAN 
ботинки - невысокой уличной обуви {обуви} 	 type:AAN 
бревно - снаряд для упражнений {снаряд} 	 type:NPN
броня - обшивка танков военных кораблей {обшивка} 	 type:NNAN 
броня - защитная обшивка танков {обшивка} 	 type:ANN 
брюзжание - надоедливое выражение недовольства {выражение} 	 type:ANN 
бутылка - Сосуд из стекла {Сосуд} 	 type:NPN
бык - животное отряда крупных парнокопытных {животное} 	 type:NNAN 
бык - рогатое животное отряда {животное} 	 type:ANN 
валенки - зимней мягкой обуви {обуви} 	 type:AAN 
вдохновение - Состояние творческого подъёма {Состояние} 	 type:NAN
веки - Части глаз живого существа {Части} 	 type:NNAN 
велосипед - колёсное транспортное средство {средство} 	 type:AAN 
венчик - Предмет кухонной утвари {Предмет} 	 type:NAN
вереница - ряд существ однородных предметов {ряд} 	 type:NNAN 
веселье - Состояние радостного оживления {Состояние} 	 type:NAN
веха - важный основной период {период} 	 type:AAN 
веха - основной период времени {период} 	 type:ANN 
вещь - изделие (бытового обихода {изделие} 	 type:NAN
вещь - предмет из числа {предмет} 	 type:NPN
витютень - дикий лесной голубь {голубь} 	 type:AAN 
властолюбие - Любовь к власти {Любовь} 	 type:NPN
влюблённость - Чувство легкой любви {Чувство} 	 type:NAN
внутренности - Совокупность органов живого существа {Совокупность} 	 type:NNAN 
возбуждение - Состояние нервного подъёма {Состояние} 	 type:NAN
возвышенность - Участок земной поверхности {Участок} 	 type:NAN
войско - Совокупность вооружённых сил {Совокупность} 	 type:NAN
волк - животное семейства псовых {животное} 	 type:NNA 
волк - хищное животное семейства {животное} 	 type:ANN 
волосы - роговые нитевидные образования {образования} 	 type:AAN 
воодушевление - Состояние душевного подъёма {Состояние} 	 type:NAN
воспоминания - воспроизведение в памяти {воспроизведение} 	 type:NPN
восторг - подъём радостных чувств {подъём} 	 type:NAN
вулкан - возвышенность конической формы {возвышенность} 	 type:NAN
вывод - Результат логического анализа {Результат} 	 type:NAN
выключатель - Устройство для замыкания {Устройство} 	 type:NPN
вырезка - Мясо высшего сорта {Мясо} 	 type:NAN
глаза - орган зрения живого существа {орган} 	 type:NNAN 
гордость - Чувство собственного достоинства {Чувство} 	 type:NAN
горшок - ёмкость из металла {ёмкость} 	 type:NPN
гребёнка - Приспособление для расчёсывания {Приспособление} 	 type:NPN
гримаса - непроизвольное искажение выражения {искажение} 	 type:ANN 
гробница - Сооружение из камня {Сооружение} 	 type:NPN
грусть - Чувство лёгкой скорби {Чувство} 	 type:NAN
дар - степень природной одарённости {степень} 	 type:NAN
дары - Святыня у христиан {Святыня} 	 type:NPN
дикарь - некультурном невежественном человеке {человеке} 	 type:AAN 
динамометр - Прибор для измерения {Прибор} 	 type:NPN
довольство - Чувство внутреннего удовольствия {Чувство} 	 type:NAN
доклад - письменное официальное сообщение {сообщение} 	 type:AAN 
долина - Место понижения земной поверхности {Место} 	 type:NNAN 
доллар - знак в США {знак} 	 type:NPN
драматургия - Совокупность драматических произведений {Совокупность} 	 type:NAN
дрожь - судорожное вздрагивание тела {вздрагивание} 	 type:ANN 
дрожь - судорожное сокращение мышц {сокращение} 	 type:ANN 
дрожь - судорожное сокращение мышц {сокращение} 	 type:ANN 
дурак - тупой упрямый человек {человек} 	 type:AAN 
дьячок - Служитель православной церкви {Служитель} 	 type:NAN
жалость - Чувство душевной боли {Чувство} 	 type:NAN
жестокость - жестокий беспощадный поступок {поступок} 	 type:AAN 
жизнь - состояние живого существа {состояние} 	 type:NAN
жнейка - Машина для скашивания {Машина} 	 type:NPN
забастовка - массовое прекращение работы {прекращение} 	 type:ANN 
закусочная - Предприятие общественного питания {Предприятие} 	 type:NAN
замазка - вещество для заделывания {вещество} 	 type:NPN
замок - Приспособление для запирания {Приспособление} 	 type:NPN
заяц - пушистый пугливый зверёк {зверёк} 	 type:AAN 
заяц - пугливый зверёк отряда {зверёк} 	 type:ANN 
зернохранилище - помещение для хранения {помещение} 	 type:NPN
злоба - Чувство гневного раздражения {Чувство} 	 type:NAN
зловоние - неприятный отвратительный запах {запах} 	 type:AAN 
злословие","злословье - враждебная оценка кого {оценка} 	 type:ANN 
злость - Чувство сильного раздражения {Чувство} 	 type:NAN
икона - Предмет религиозного почитания {Предмет} 	 type:NAN
икона - Произведение изобразительного искусства {Произведение} 	 type:NAN
иллюстрация - Произведение изобразительного искусства {Произведение} 	 type:NAN
имущество - предметы быта личного обихода {предметы} 	 type:NNAN 
интроспекция - Метод изучения психических процессов {Метод} 	 type:NNAN 
истерия - лихорадочная судорожная деятельность {деятельность} 	 type:AAN 
истерия - пристрастное выражение чего-либо {выражение} 	 type:ANN 
календула - растение семейства сложноцветных {растение} 	 type:NNA 
календула - садовое травянистое растение {растение} 	 type:AAN 
календула - травянистое растение семейства {растение} 	 type:ANN 
каморка - помещение для жилья {помещение} 	 type:NPN
капище - Сооружение культового назначения {Сооружение} 	 type:NAN
каприз - необоснованное своенравное желание {желание} 	 type:AAN 
каприз - своенравное желание требование {желание} 	 type:ANN 
картина - Произведение изобразительного искусства {Произведение} 	 type:NAN
кладовая - Помещение без окон {Помещение} 	 type:NPN
клевер - растение семейства бобовых {растение} 	 type:NNA 
клевер - кормовое растение семейства {растение} 	 type:ANN 
козни - Действия против кого-либо {Действия} 	 type:NPN
колдовство - Система магических приёмов {Система} 	 type:NAN
компакт-диск - Диск небольшого диаметра {Диск} 	 type:NAN
кораблестроитель - Специалист в области {Специалист} 	 type:NPN
корова - животное отряда крупных парнокопытных {животное} 	 type:NNAN 
корова - рогатое животное отряда {животное} 	 type:ANN 
коротышка - Человек невысокого роста {Человек} 	 type:NAN
красавица - хорошенькая миловидная женщина {женщина} 	 type:AAN 
крещение - основных православных праздников {праздников} 	 type:AAN 
крик - напряженный звук голоса {звук} 	 type:ANN 
крик - резкий звук голоса {звук} 	 type:ANN 
крокодил - хищное водное пресмыкающееся {пресмыкающееся} 	 type:AAN 
кружка - Сосуд из стекла {Сосуд} 	 type:NPN
кулик - птица семейства ржанковых {птица} 	 type:NNA 
кулик - болотная птица семейства {птица} 	 type:ANN 
культура - Совокупность достижений человеческого общества {Совокупность} 	 type:NNAN 
кулёк - вместилище из бумаги {вместилище} 	 type:NPN
курица - птицы отряда куриных {птицы} 	 type:NNA 
курица - домашней птицы отряда {птицы} 	 type:ANN 
кусачки - щипцы для откусывания {щипцы} 	 type:NPN
ласточка - птица отряда воробьиных {птица} 	 type:NNA 
лексикограф - Специалист в области {Специалист} 	 type:NPN
леопард - хищное млекопитающее семейства {млекопитающее} 	 type:ANN 
лесть - угодливое восхваление кого-либо {восхваление} 	 type:ANN 
лисица - млекопитающее семейства псовых {млекопитающее} 	 type:NNA 
ловушка - Приспособление для ловли {Приспособление} 	 type:NPN
ловушка - расположение воинского подразделения {расположение} 	 type:NAN
луг - Участок земной поверхности {Участок} 	 type:NAN
любовь - Чувство глубокой привязанности {Чувство} 	 type:NAN
малиновка - птица семейства дроздовых {птица} 	 type:NNA 
малиновка - певчая птица семейства {птица} 	 type:ANN 
манёвры","маневры - занятия различных родов {занятия} 	 type:NAN
маслина - дерево семейства масличных {дерево} 	 type:NNA 
маслина - вечнозеленое плодовое дерево {дерево} 	 type:AAN 
маслина - плодовое дерево семейства {дерево} 	 type:ANN 
медведь - хищное всеядное млекопитающее {млекопитающее} 	 type:AAN 
метель - порывистый холодный ветер {ветер} 	 type:AAN 
метро - подземная железная дорога {дорога} 	 type:AAN 
мина - подводный разрывной снаряд {снаряд} 	 type:AAN 
молодёжь - Совокупность молодых людей {Совокупность} 	 type:NAN
монастырь - Комплекс сооружений богослужебных {Комплекс} 	 type:NNA 
морг - Помещение для покойников {Помещение} 	 type:NPN
мухобойка - Приспособление для уничтожения {Приспособление} 	 type:NPN
набег - действия небольших отрядов {действия} 	 type:NAN
наживка - Приманка для рыбы {Приманка} 	 type:NPN
напряжённность - интенсивное протекание эмоций {протекание} 	 type:ANN 
напряжённость - неспокойное нервное состояние {состояние} 	 type:AAN 
нарыв - гнойное воспаление ткани {воспаление} 	 type:ANN 
насыпь - возвышение из земли {возвышение} 	 type:NPN
неблагородство - Отсутствие благородства хорошего воспитания {Отсутствие} 	 type:NNAN 
негодяй - нравственном отношении человек {отношении} 	 type:ANN 
недостача - Отсутствие нужного количества {Отсутствие} 	 type:NAN
недоумение - Состояние лёгкого удивления {Состояние} 	 type:NAN
неистовость - Качество человека склонного {Качество} 	 type:NNA 
нелюдимость - Качество необщительного человека {Качество} 	 type:NAN
ненужный - нужды необходимости действительной потребности {нужды} 	 type:NNAN 
необщительность - Свойство неразговорчивого человека {Свойство} 	 type:NAN
необычность - особенными специфическими качествами {качествами} 	 type:AAN 
непривычность - знакомо малоизвестно необычность {необычность} 	 type:AAN 
неуважение - Отсутствие должного уважения {Отсутствие} 	 type:NAN
неуравновешенность - Склонность к возбудимости {Склонность} 	 type:NPN
образ - художественное отражение действительности {отражение} 	 type:ANN 
объединение - Создание единого целого {Создание} 	 type:NAN
объявление - письменный печатный текст {текст} 	 type:AAN 
оговорка - ошибка в речи {ошибка} 	 type:NPN
огонь - газы красно цвета {газы} 	 type:NAN
одиночество - состояние отсутствия душевной связи {состояние} 	 type:NNAN 
оживление - Переход из состояния {Переход} 	 type:NPN
оклад - Предмет религиозного обихода {Предмет} 	 type:NAN
осквернение - жестокое оскорбительное издевательство {издевательство} 	 type:AAN 
осьминог - животное из класса {животное} 	 type:NPN
официант - Работник предприятия общественного питания {Работник} 	 type:NNAN 
палец - подвижных конечных частей {частей} 	 type:AAN 
палец - конечных частей руки {частей} 	 type:ANN 
памятник - Произведение изобразительного искусства {Произведение} 	 type:NAN
паротит - заболевание желез внутренней секреции {заболевание} 	 type:NNAN 
паротит - детское острозаразное заболевание {заболевание} 	 type:AAN 
паротит - острозаразное заболевание желез {заболевание} 	 type:ANN 
патриотизм - Чувство глубокой привязанности {Чувство} 	 type:NAN
пачка - Совокупность однородных предметов {Совокупность} 	 type:NAN
пение - Исполнение вокального произведения {Исполнение} 	 type:NAN
перегородка - тонкая внутренняя стенка {стенка} 	 type:AAN 
писатель - Создатель литературных произведений {Создатель} 	 type:NAN
повар - Работник предприятия общественного питания {Работник} 	 type:NNAN 
поговорка - меткое образное выражение {выражение} 	 type:AAN 
подавленность - Состояние крайней огорчённости {Состояние} 	 type:NAN
подсвечник - Приспособление для свечи {Приспособление} 	 type:NPN
подчинение - Зависимость от кого-либо {Зависимость} 	 type:NPN
показание - письменное сообщение сведений {сообщение} 	 type:ANN 
половник - ложка для разливания {ложка} 	 type:NPN
помидор - растение семейства паслёновых {растение} 	 type:NNA 
помидор - овощное огородное растение {растение} 	 type:AAN 
помидор - огородное растение семейства {растение} 	 type:ANN 
попугай - Птица тропических стран {Птица} 	 type:NAN
портсигар - вместилище из металла {вместилище} 	 type:NPN
порча - способность при помощи {способность} 	 type:NPN
поступок - целенаправленное проявление деятельности {проявление} 	 type:ANN 
потворство - мягкое снисходительное отношение {отношение} 	 type:AAN 
потомки - Люди последующих поколений {Люди} 	 type:NAN
почва - слой земной коры {слой} 	 type:NAN
поэт - Автор поэтических произведений {Автор} 	 type:NAN
правительство - Группа должностных лиц {Группа} 	 type:NAN
преследование - нападки на кого-либо {нападки} 	 type:NPN
пресмыкающееся - Животное класса позвоночных {Животное} 	 type:NNA 
признание - откровенное изложение чего-либо {изложение} 	 type:ANN 
приказ - документ установленной формы {документ} 	 type:NAN
принуждение - воздействие на кого-либо {воздействие} 	 type:NPN
приток - подъём уровня открытого моря {подъём} 	 type:NNAN 
прищепка - Приспособление для прикрепления {Приспособление} 	 type:NPN
пробка - Приспособление для закрывания {Приспособление} 	 type:NPN
произведение - Результат творческих усилий {Результат} 	 type:NAN
пропасть - глубокое узкое углубление {углубление} 	 type:AAN 
проповедь - Распространение христианской религии {Распространение} 	 type:NAN
простор - открытое свободное пространство {пространство} 	 type:AAN 
профессия - занятий трудовой деятельности {занятий} 	 type:NAN
пряник - изделие из теста {изделие} 	 type:NPN
пряник - мягкое печёное изделие {изделие} 	 type:AAN 
психоз - Заболевание головного мозга {Заболевание} 	 type:NAN
пузырёк - сосуд из стекла {сосуд} 	 type:NPN
пустословие - бесполезные речи разговоры {речи} 	 type:ANN 
пустяк - маловажное несущественное обстоятельство {обстоятельство} 	 type:AAN 
пыл - возбуждение душевного воодушевления {возбуждение} 	 type:NAN
пыл - внутреннее психическое возбуждение {возбуждение} 	 type:AAN 
радость - Чувство большого удовольствия {Чувство} 	 type:NAN
развитие - Процесс закономерного изменения {Процесс} 	 type:NAN
размазня - нерешительный слабохарактерный человек {человек} 	 type:AAN 
раскол - движение в России {движение} 	 type:NPN
расположение - благоприятное благожелательное отношение {отношение} 	 type:AAN 
расшифровка - Раскрытие системы условных знаков {Раскрытие} 	 type:NNAN 
река - непрерывный водный поток {поток} 	 type:AAN 
репейник - растение семейства сложноцветных {растение} 	 type:NNA 
рисунок - Произведение изобразительного искусства {Произведение} 	 type:NAN
рубашка - белье произвольной длины {белье} 	 type:NAN
ругань - Использование в речи {Использование} 	 type:NPN
рукопись - Памятник древней письменности {Памятник} 	 type:NAN
румянец - алый цвет щёк {цвет} 	 type:ANN 
ряд - Совокупность однородных предметов {Совокупность} 	 type:NAN
светолечение - Применение световых лучей {Применение} 	 type:NAN
свирепость - Склонность к жестокости {Склонность} 	 type:NPN
свобода - Пребывание вне заключения {Пребывание} 	 type:NPN
семья - Группа близких родственников {Группа} 	 type:NAN
сила - Способность живых существ {Способность} 	 type:NAN
силок - Приспособление для ловли {Приспособление} 	 type:NPN
скала - Участок земной поверхности {Участок} 	 type:NAN
скульптура - Искусство создания объёмных {Искусство} 	 type:NNA 
слабоумие - Заболевание нервной системы {Заболевание} 	 type:NAN
собака - животное семейства псовых {животное} 	 type:NNA 
согласованность - строение частей способных {строение} 	 type:NNA 
солдат - Военнослужащий сухопутных войск {Военнослужащий} 	 type:NAN
соус - приправа к кушанью {приправа} 	 type:NPN
спокойствие - Состояние душевного равновесия {Состояние} 	 type:NAN
справедливость - Соответствие человеческих отношений {Соответствие} 	 type:NAN
ссора - Состояние взаимной вражды {Состояние} 	 type:NAN
ссора - Состояние взаимной неприязни {Состояние} 	 type:NAN
ссора - Столкновение противоположных сторон {Столкновение} 	 type:NAN
стадо - Группа домашних парнокопытных {Группа} 	 type:NAN
статуэтка - Произведение изобразительного искусства {Произведение} 	 type:NAN
стиль - Совокупность языковых приёмов {Совокупность} 	 type:NAN
стоянка - Место временного расположения {Место} 	 type:NAN
страсть - чувство сердечной склонности {чувство} 	 type:NAN
страх - Чувство сильной тревоги {Чувство} 	 type:NAN
судорога - болезненное сокращение мышц {сокращение} 	 type:ANN 
сырник - Кушанье из творога {Кушанье} 	 type:NPN
такси - Автомобиль для перевозки {Автомобиль} 	 type:NPN
тапки - туфли без каблуков {туфли} 	 type:NPN
теолог - Специалист в области {Специалист} 	 type:NPN
тепло - тёплая жаркая погода {погода} 	 type:AAN 
толпа - Скопление людей стоящих {Скопление} 	 type:NNA 
траулер - промысловое рыболовецкое судно {судно} 	 type:AAN 
троица - основных православных праздников {праздников} 	 type:AAN 
троица - основных христианских догматов {догматов} 	 type:AAN 
уверенность - вера в кого {вера} 	 type:NPN
укол - Введение лекарственных препаратов {Введение} 	 type:NAN
уловка - изобретательный мудрёный приём {приём} 	 type:AAN 
уныние - состояние духа гнетущей безнадежности {состояние} 	 type:NNAN 
ферзь - сильная шахматная фигура {фигура} 	 type:AAN 
ферма - животноводческое сельскохозяйственное предприятие {предприятие} 	 type:AAN 
филолог - Специалист по филологии {Специалист} 	 type:NPN
философ - Специалист по философии {Специалист} 	 type:NPN
фляга - ёмкость из пластмассы {ёмкость} 	 type:NPN
форма - внешние очертания предмета {очертания} 	 type:ANN 
церковь - Сооружение культового назначения {Сооружение} 	 type:NAN
человеколюбие - Чувство безграничной любви {Чувство} 	 type:NAN
чибис - птица семейства ржанковых {птица} 	 type:NNA 
чувство - душевное психическое состояние {состояние} 	 type:AAN 
чувство - психическое состояние человека {состояние} 	 type:ANN 
чуткость - заботливое сочувственное отношение {отношение} 	 type:AAN 
шашка - Фигура для игры {Фигура} 	 type:NPN
шкатулка - вместилище из дерева {вместилище} 	 type:NPN
шпилька - Приспособление для закалывания {Приспособление} 	 type:NPN
штопор - Приспособление для откупоривания {Приспособление} 	 type:NPN
щеколда - Приспособление для запирания {Приспособление} 	 type:NPN
экспорт - Деятельность по продаже {Деятельность} 	 type:NPN
эскиз - Произведение изобразительного искусства {Произведение} 	 type:NAN
юрок - птица отряда воробьиных {птица} 	 type:NNA 
юрок - таёжная птица отряда {птица} 	 type:ANN 
юрта - сооружение конусообразной формы {сооружение} 	 type:NAN
