абиссинцы - населения Эфиопии {населения}
абонемент - Право пользования {Право}
аборт - прекращение беременности {прекращение}
абрек - период присоединения {период}
абсолютист - Сторонник абсолютизма {Сторонник}
абстракционист - Последователь абстракционизма {Последователь}
абсцесс - воспаление тканей {воспаление}
абцуг - пара карт {пара}
авангардизм - Стремление какой {Стремление}
авангардист - Последователь авангардизма {Последователь}
авантюрист - Искатель приключений {Искатель}
аварийность - Наличие аварий {Наличие}
авиаконструктор - Конструктор самолетов {Конструктор}
авиапочта - Перевозка почты {Перевозка}
авиастроение - Отрасль промышленности {Отрасль}
автодело - Круг знаний {Круг}
автоколонна - Колонна автомашин {Колонна}
автоматика - Отрасль науки {Отрасль}
автомобилестроение - Отрасль промышленности {Отрасль}
автопортрет - Портрет художника {Портрет}
авторство - Принадлежность произведения {Принадлежность}
автосервис - обслуживание автомобилей {обслуживание}
автотехобслуживание - обслуживание автомобилей {обслуживание}
автотипия - способ воспроизведения {способ}
автохтоны - население страны {население}
агент - Представитель организации {Представитель}
агентство - отделение какого {отделение}
агитпоход - Поход агитколлектива {Поход}
агитпроп - отделов агитации {отделов}
агломерат - скопление обломков {скопление}
агностик - Последователь агностицизма {Последователь}
агония - состояние организма {состояние}
агрегат - машин устройств {машин}
агреман - Согласие правительства {Согласие}
агрокультура - Совокупность приемов {Совокупность}
агротехника - Система приемов {Система}
адаптация - Приспособление организмов {Приспособление}
адвокатство - Деятельность адвоката {Деятельность}
адвокатура - Деятельность адвоката {Деятельность}
аджарцы - группа грузин {группа}
администрация - орган лица {орган}
адмиралтейство - Место постройки {Место}
адмиральша - Жена адмирала {Жена}
адреналин - Гормон надпочечников {Гормон}
адсорбция - Поглощение частиц {Поглощение}
аз - буквы «а {буквы}
азбука - Совокупность букв {Совокупность}
азот - элемент питания {элемент}
азям - одежда крестьян {одежда}
аистенок - Птенец аиста {Птенец}
академик - член академии {член}
акванавт - Исследователь моря {Исследователь}
акватория - поверхность чего {поверхность}
акклиматизация - Приспособление человека {Приспособление}
акмеист - Последователь акмеизма {Последователь}
акробат - гимнаст номеров {гимнаст}
аксессуар - Принадлежность чего {Принадлежность}
аксиоматика - Совокупность аксиом {Совокупность}
акт - проявление какой {проявление}
актер - исполнитель ролей {исполнитель}
активист - член какого {член}
актиния - животное класса {животное}
акушерство - Раздел медицины {Раздел}
акцентуация - Система ударения {Система}
алгебра - Раздел математики {Раздел}
алгоритм - Система вычислений {Система}
алиби - Пребывание обвиняемого {Пребывание}
аллах","алла - Наименование бога {Наименование}
аллергия - чувствительность организма {чувствительность}
аллилуйщина - восхваление кого {восхваление}
аллитерация - прием усиления {прием}
аллювий - Наносы отложения {Наносы}
алогизм - Ход мысли {Ход}
альманах - сборник произведений {сборник}
альпинарий - Участок сада {Участок}
альпиниада - поход альпинистов {поход}
альтернатива - Необходимость выбора {Необходимость}
альфа-распад - Испускание альфа-частиц {Испускание}
альфа-частица - Ядро атома {Ядро}
амальгама - Сплав какого {Сплав}
амальгамация - Способ извлечения {Способ}
амброзия - пища богов {пища}
аммоний - Группа атомов {Группа}
аморализм - Отрицание морали {Отрицание}
амортизация - снижение ценности {снижение}
ампер - Единица измерения {Единица}
амплификация - прием усиления {прием}
амплуа - Специализация актера {Специализация}
амуниция - Снаряжение военнослужащего {Снаряжение}
амур - бог любви {бог}
анабиоз - Явление приспособления {Явление}
анаграмма - Перестановка букв {Перестановка}
анархист - Сторонник анархизма {Сторонник}
анархия - Состояние общества {Состояние}
анархо-синдикалист - Сторонник анархо-синдикализма {Сторонник}
ангажемент - Приглашение артистов {Приглашение}
ангстрем - Единица длины {Единица}
аневризма - расширение просвета {расширение}
анестезиология - Раздел медицины {Раздел}
анкер - Деталь часов {Деталь}
аннексионист - Сторонник аннексии {Сторонник}
аннотация - характеристика книги {характеристика}
аноним - Автор сочинения {Автор}
ансамбль - согласованность какого {согласованность}
антимилитарист - Сторонник антимилитаризма {Сторонник}
антимир - объект (типа {объект}
антипатия - Чувство неприязни {Чувство}
антисемит - Последователь антисемитизма {Последователь}
антисоветчина - деятельность высказывания {деятельность}
антихрист - противник Христа {противник}
антрепренерство - Деятельность антрепренера {Деятельность}
антресоли - этаж дома {этаж}
антропометрия - Совокупность приемов {Совокупность}
аорист - времени глагола {времени}
апогей - Точка орбиты {Точка}
апологетика - Раздел богословия {Раздел}
апоселений - Точка орбиты {Точка}
апофеоз - обряд обожествления {обряд}
апоцентр - Точка орбиты {Точка}
аппаратура - Совокупность аппаратов {Совокупность}
аппендицит - Воспаление аппендикса {Воспаление}
апперцепция - Зависимость восприятия {Зависимость}
аппликация - Способ создания {Способ}
аппретура - Обработка ткани {Обработка}
аптекарша - Женщина аптекаря {Женщина}
аптекарь - Работник аптеки {Работник}
арабистика - Совокупность наук {Совокупность}
арабы - группа народов {группа}
арго - язык какой {язык}
арифметика - Раздел математики {Раздел}
арка - перекрытие проема {перекрытие}
армада - соединение кораблей {соединение}
арматура - Комплект предметов {Комплект}
ароматизация - Способ переработки {Способ}
арсенал - Склад оружия {Склад}
артель - Объединение лиц {Объединение}
артериосклероз - заболевание артерий {заболевание}
артикуляция - Работа органов {Работа}
артрит - Воспаление суставов {Воспаление}
архиерей - чинов духовенства {чинов}
архимандрит - Титул настоятеля {Титул}
архипастырь - чинов духовенства {чинов}
архитектоника - расположение частей {расположение}
архитектура - Искусство проектирования {Искусство}
аршин - мера длины {мера}
аршинник - купца торговца {купца}
асептика - Меры обеззараживания {Меры}
аспект - Точка зрения {Точка}
аспирантура - Система подготовки {Система}
ассамблея - собрание какой {собрание}
ассигновка - распорядителем кредита {распорядителем}
ассимилятор - Сторонник ассимиляторства {Сторонник}
ассирияне - Население Ассирии {Население}
ассистент - Помощник профессора {Помощник}
ассоциация - Объединение лиц {Объединение}
астероиды - Малые планеты {Малые}
астма - Приступы удушья {Приступы}
астроботаника - Раздел астробиологии {Раздел}
астрометрия - Раздел астрономии {Раздел}
астронавигация - Метод навигации {Метод}
астрофизика - Раздел астрономии {Раздел}
асфиксия - расстройство дыхания {расстройство}
атака - нападение войск {нападение}
атеизм - Отрицание существования {Отрицание}
атеист - Последователь атеизма {Последователь}
ателье - Мастерская одежды {Мастерская}
атмосфера - оболочка Земли {оболочка}
атония - Ослабление напряжения {Ослабление}
атрибут - свойство предмета {свойство}
атрофия - Потеря жизнеспособности {Потеря}
аукцион - продажа какого {продажа}
аут - перелет мяча {перелет}
афазия - Расстройство речи {Расстройство}
африканистика - Совокупность наук {Совокупность}
ацтеки - народность Мексики {народность}
аэрология - Раздел метеорологии {Раздел}
аэромеханика - Раздел механики {Раздел}
аэросъемка - Съемка местности {Съемка}
аэрофотография - Раздел фотографии {Раздел}
аэрофотосъемка - Фотографирование местности {Фотографирование}
бабка - сустав ноги {сустав}
бабка - образом снопов {образом}
бабушка - Мать отца {Мать}
бабье - Бабы женщины {Бабы}
байронизм - течение начала {течение}
бактериоз - Болезнь растения {Болезнь}
бакштов - Конец троса {Конец}
балерина - Артистка балета {Артистка}
балкон - стене здания {стене}
балясина - столбик перил {столбик}
банда - группа людей {группа}
бандит - Участник банды {Участник}
банкротство - Несостоятельность лица {Несостоятельность}
банту - Семья языков {Семья}
банщик - Работник бани {Работник}
баптист - Последователь баптизма {Последователь}
бар - Единица измерения {Единица}
баран - Самец овцы {Самец}
баранина - Мясо барана {Мясо}
барда - Отходы винокурения {Отходы}
барич - Сын барина {Сын}
баронство - Титул барона {Титул}
барство - Помещики господа {Помещики}
барсучиха - Самка барсука {Самка}
бархатка - -ток дат {-ток}
барчук - сын барина {сын}
барщина - труд крестьян {труд}
барышничество - Занятие барышника {Занятие}
барышня - дочь барина {дочь}
басма' - листы металла {листы}
баснописец - Автор басен {Автор}
батареец - Боец батареи {Боец}
батог - Палка трость {Палка}
батрачество - Занятие батрака {Занятие}
бахтарма - сторона кожи {сторона}
безбожие - Отрицание существования {Отрицание}
безверие - Отсутствие веры {Отсутствие}
безветрие - Отсутствие ветра {Отсутствие}
безвинность - Отсутствие вины {Отсутствие}
безвкусица - Проявление безвкусия {Проявление}
безвластие - Отсутствие власти {Отсутствие}
безволие - Отсутствие силы {Отсутствие}
бездействие - Отсутствие всякой# {Отсутствие}
бездефектность - Отсутствие дефектов {Отсутствие}
бездождие - отсутствие дождя {отсутствие}
бездолье - Несчастье невзгоды {Несчастье}
беззастенчивость - Отсутствие застенчивости {Отсутствие}
безземелье - Недостаток земли {Недостаток}
безлесье - Отсутствие лесов {Отсутствие}
безлюдье - Отсутствие людей {Отсутствие}
безмолвие - Молчание звуков {Молчание}
безначалие - Отсутствие власти {Отсутствие}
безотрадность - Отсутствие отрады {Отсутствие}
безотцовщина - Отсутствие отца {Отсутствие}
бейка - Полоска ткани {Полоска}
бекас - птица отряда {птица}
белек - Детеныш тюленя {Детеныш}
белизна - цвет чего {цвет}
белка - зверек отряда {зверек}
белокровие - Заболевание крови {Заболевание}
белужина - Мясо белуги {Мясо}
бельгийцы - Население Бельгии {Население}
бельчонок - Детеныш белки {Детеныш}
бельэтаж - этаж дома {этаж}
бенуар - ярус лож {ярус}
берберы - Группа народов {Группа}
берег - Край земли {Край}
беременность - Состояние женщины {Состояние}
береста - слой коры {слой}
бери-бери - Болезнь обмена {Болезнь}
берковец - мера веса {мера}
берлога - Логово медведя {Логово}
бескормица - Недостаток корма {Недостаток}
бескорыстие - Отсутствие стремления {Отсутствие}
бескультурье - Отсутствие культуры {Отсутствие}
беспамятство - Потеря сознания {Потеря}
беспокойство - состояние волнение {состояние}
бесправие - Отсутствие прав {Отсутствие}
беспристрастие - Отсутствие пристрастия {Отсутствие}
бессердечие - Отсутствие сердечности {Отсутствие}
бессмыслие - Отсутствие мысли {Отсутствие}
бессонница - отсутствие сна {отсутствие}
бесстрастие - Отсутствие страстей {Отсутствие}
бесстрашие - Отсутствие страха {Отсутствие}
бесстыдство - Отсутствие стыда {Отсутствие}
бесхребетность - Отсутствие твердости {Отсутствие}
бесчестье - Поругание чести {Поругание}
бесчинство - Нарушение порядка {Нарушение}
бесчувствие - Потеря сознания {Потеря}
бета-лучи - Поток бета-частиц {Поток}
бешенство - болезнь животных {болезнь}
библиотекарь - Работник библиотеки {Работник}
библиотековедение - Отрасль науки {Отрасль}
библиотечка - собрание книг {собрание}
бивак - Стоянка войск {Стоянка}
бинт - Кусок марли {Кусок}
биограф - Составитель биографии {Составитель}
биография - Описание чьей {Описание}
биология - Совокупность наук {Совокупность}
биопсия - Иссечение кусочка {Иссечение}
биоритм - колебания интенсивности {колебания}
биоритмика - Совокупность проявлений {Совокупность}
биосфера - Оболочка Земли {Оболочка}
бисерина - зерно бисера {зерно}
бифштекс - кусок говядины {кусок}
благодарение - Выражение признательности {Выражение}
благодарность - Чувство признательности {Чувство}
благоприобретение - Приобретение чего {Приобретение}
блаженство - степень счастья {степень}
бланк - Лист бумаги {Лист}
бластула - Стадия развития {Стадия}
блат - язык (арго {язык}
блестки - пластинки чешуйки {пластинки}
блеяние - Крик овец {Крик}
близорукость - Недостаток зрения {Недостаток}
блик - Отблеск света {Отблеск}
блинт - Тиснение надписей {Тиснение}
блок - Объединение государств {Объединение}
блокада - Окружение города {Окружение}
бобер - Мех бобра {Мех}
бобр - Животное отряда {Животное}
бобренок - Детеныш бобра {Детеныш}
бобриха - Самка бобра {Самка}
богатырство - качества богатырей {качества}
богатырь - Герой русских {Герой}
богородица - матери Христа {матери}
богохульство - Поношение бога {Поношение}
боекомплект - количество боеприпасов {количество}
боепитание - Обеспеченне войск {Обеспеченне}
боец - Участник боев {Участник}
болван - обрубок дерева {обрубок}
болванка - Слиток металла {Слиток}
боливийцы - Население Боливии {Население}
болтун - яйцо птицы {яйцо}
бомбометание - сбрасывание бомб {сбрасывание}
бонапартист - Сторонник бонапартизма {Сторонник}
бонитет - Показатель качества {Показатель}
боргес - размеров шрифта {размеров}
боров - самец свиньи {самец}
борт - край одежды {край}
бортинженер - Член экипажа {Член}
босячество - Образ жизни {Образ}
боязнь - Чувство страха {Чувство}
боярыня - Жена боярина {Жена}
боярышня - дочь боярина {дочь}
брага - напиток род {напиток}
бражничество - Провождение времени {Провождение}
брак - союз мужчины {союз}
бракераж - Определение сорта {Определение}
бред - речь больного {речь}
бригадир - Руководитель бригады {Руководитель}
бригадник - Член бригады {Член}
бро'ня - Закрепление какого {Закрепление}
бровь - полоска волос {полоска}
брожение - Процесс распада {Процесс}
бронза - Сплав меди {Сплав}
брус - кусок дерева {кусок}
брусничник - Заросли брусники {Заросли}
бруцеллез - заболевание коз {заболевание}
брыжейка - Складка брюшины {Складка}
брызги - Капли жидкости {Капли}
брюквина - штука брюквы {штука}
брюхо - Живот человека {Живот}
брюховина - желудок кишки {желудок}
буддист - Последователь буддизма {Последователь}
бузинник - Заросли бузины {Заросли}
буйволица - Самка буйвола {Самка}
буквоедство - толкование чего {толкование}
букетировка - Способ ухода {Способ}
булочник - Владелец булочной {Владелец}
бумагопрядение - Производство пряжи {Производство}
бундесрат - Орган представительства {Орган}
бунтарство - Проявление непокорности {Проявление}
буржуа - Представитель класса {Представитель}
бурсак - Воспитанник бурсы {Воспитанник}
бурт - куча овощей {куча}
буртование - Закладка овощей {Закладка}
бусина - зерно бус {зерно}
бутерброд - Ломтик хлеба {Ломтик}
бутон - Почка цветка {Почка}
буффонада - прием изображения {прием}
бучение - варка тряпья {варка}
бушель - Мера емкости {Мера}
бык - животное подсемейства {животное}
былинка - Стебель травы {Стебель}
былинщик - Певец былин {Певец}
быт - уклад жизни {уклад}
бытописатель - Автор произведений {Автор}
бытописательство - Изображение быта {Изображение}
бычатина - Мясо быка {Мясо}
бычина - Шкура быка {Шкура}
бьеф - Участок реки {Участок}
бюджет - Смета доходов {Смета}
бюрократ - Представитель бюрократии {Представитель}
бюрократизм - Система управления {Система}
вагоновожатый - Водитель трамвая {Водитель}
вайя - Лист папоротника {Лист}
вакации - Перерыв занятий {Перерыв}
вакханка - жрица бога {жрица}
вакцинация - прививка вакцины {прививка}
вал - Деталь машины {Деталь}
вал - объем продукции {объем}
валентность - Способность атома {Способность}
вариант - видоизменение чего {видоизменение}
вариометр - приборов служащих {приборов}
варяги - норманнов дружины {норманнов}
ватт - Единица измерения {Единица}
ватт-секунда - Единица измерения {Единица}
ватт-час - Единица измерения {Единица}
вафельница - выпечки вафель {выпечки}
вахмистр - звание фельдфебеля {звание}
вдовство - состояние вдовца {состояние}
вдох - впуск воздуха {впуск}
вегетарианство - Система питания {Система}
век - Промежуток времени {Промежуток}
веки - складки кожи {складки}
величество - Титулование монархов {Титулование}
венерология - Отрасль медицины {Отрасль}
вензель - буквы имени {буквы}
веник - Связка прутьев {Связка}
венчание - Обряд возведения {Обряд}
верблюдица - Самка верблюда {Самка}
верблюжина - Мясо верблюда {Мясо}
верблюжонок - Детеныш верблюда {Детеныш}
веревка - шнура пряди {шнура}
веретеница - змею ящерицы {змею}
вероломство - Нарушение обязательства {Нарушение}
веротерпимость - Признание права {Признание}
вероятность - возможность осуществления {возможность}
версия - друг изложений {друг}
верста - мера длины {мера}
верстак - стол слесарной {стол}
вертеп - Пещера преступников {Пещера}
вертикаль - направление отвеса {направление}
вершок - мера длины {мера}
вес - Тяжесть какого {Тяжесть}
весна - Время года {Время}
ветер - Движение потока {Движение}
ветеринария - Система наук {Система}
ветошка - лоскут чего {лоскут}
ветошник - Скупщик ветоши {Скупщик}
ветроэнергетика - Область техники {Область}
вечер - Время суток {Время}
вечность - Течение времени {Течение}
вещество - сущность материи {сущность}
вещь - предмет явления {предмет}
взаимность - чувство (симпатии {чувство}
взаимодействие - связь предметов {связь}
взаимообусловленность - обусловленность явлений {обусловленность}
взаимоотношение - Отношение предметов {Отношение}
взблеск - Вспышка света {Вспышка}
взвар - Отвар ягод {Отвар}
взнос - Внесение денег {Внесение}
взяток - Добыча пчелы {Добыча}
взяточничество - Получение взяток {Получение}
вигвам - хижина индейцев {хижина}
виги - партия Великобритании {партия}
вигонь - млекопитающее рода {млекопитающее}
вид - облик кого {облик}
вид - понятие особей {понятие}
видоискатель - устройство фото {устройство}
видообразование - Процесс образования {Процесс}
византиноведение - Отрасль медиевистики {Отрасль}
визготня - крики взвизгивания {крики}
визирь - Титул министров {Титул}
визит - посещение кого {посещение}
визитация - Проверка документов {Проверка}
виконт - титул барона {титул}
виктория - растений (земляники {растений}
виновность - Наличие вины {Наличие}
виноградина - Ягода винограда {Ягода}
виноделие - Изготовление вина {Изготовление}
винокурение - Производство спирта {Производство}
виртуозность - мастерство артиста {мастерство}
витаминизация - Введение витаминов {Введение}
вихор - прядь волос {прядь}
вихрь - движение ветра {движение}
вицмундир - фрак чиновников {фрак}
вишня - дерево кустарника {дерево}
вкусовщина - Оценка каких {Оценка}
владетель - Правитель государства {Правитель}
влажность - Наличие влаги {Наличие}
власть - Право управления {Право}
внимание - Сосредоточенность мыслей {Сосредоточенность}
внимательность - Проявление внимания {Проявление}
внук - Сын дочери {Сын}
внучата - Внуки внучки {Внуки}
внучка - Дочь сына {Дочь}
водность - Наличие воды {Наличие}
водоворот - движение воды {движение}
водоем - Место скопления {Место}
водозабор - Подача воды {Подача}
водолечение - Применение воды {Применение}
водоотвод - Система мероприятий {Система}
водопад - Поток воды {Поток}
водопользование - Порядок условия {Порядок}
водоскат - Падение воды {Падение}
водоснабжение - Система мероприятий {Система}
водоток - потоков (рек {потоков}
водянка - Скопление жидкости {Скопление}
воевода - Начальник войска {Начальник}
военачальник - Начальник войска {Начальник}
вождь - Предводитель войска {Предводитель}
возгонка - переход вещества {переход}
воздержание - Ограничение себя {Ограничение}
воззрение - Образ мыслей {Образ}
возраст - Количество времени {Количество}
волеизъявление - Проявление воли {Проявление}
волнение - Движение волн {Движение}
воловина - Шкура вола {Шкура}
волосатость - Степень покрытия {Степень}
волхв - Колдун чародей {Колдун}
волчанка - туберкулеза кожи {туберкулеза}
волчица - Самка волка {Самка}
волчонок - Детеныш волка {Детеныш}
волшебник - Колдун чародей {Колдун}
вольница - группы населения {группы}
вольтерьянец - Последователь Вольтера {Последователь}
волюнтарист - Последователь волюнтаризма {Последователь}
вооруженность - Оснащенность какими {Оснащенность}
вопленица - Исполнительница плачей {Исполнительница}
вопросник - Перечень вопросов {Перечень}
воробьенок - Птенец воробья {Птенец}
воробьиха - Самка воробья {Самка}
воровство - Хищение чьей {Хищение}
вороненок - Птенец ворона {Птенец}
вороток - инструмент (разверток {инструмент}
ворсинка - Волосок ворса {Волосок}
ворсянка - растение соцветия {растение}
воскресенье - день отдыха {день}
воскресник - выполнение какой {выполнение}
восток - стран света {стран}
востоковедение - Совокупность наук {Совокупность}
восхищение - степень удовлетворения {степень}
восьмерик - мера (счета {мера}
восьмидесятилетие - Промежуток времени {Промежуток}
восьмисотлетие - Промежуток времени {Промежуток}
вотчинник - Владелец вотчины {Владелец}
враки - Ложь выдумки {Ложь}
время - Длительность существования {Длительность}
времяисчисление - Счет времени {Счет}
времяпрепровождение - Использование времени {Использование}
врубок - Кусок дерева {Кусок}
всеведение - Знание всего {Знание}
вседержитель - названий бога {названий}
вселенная - система мироздания {система}
всеобуч - обучение детей {обучение}
всепрощение - прощение всего {прощение}
всполье - Окраина поля {Окраина}
вспоможение - Оказание помощи {Оказание}
всходы - Ростки семян {Ростки}
всхожесть - Способность (семян {Способность}
втулка - деталь какого {деталь}
вузовец - Студент вуза {Студент}
вулканизация - Обработка каучука {Обработка}
вулканизм - Совокупность явлений {Совокупность}
вулканология - Отрасль геологии {Отрасль}
выборность - Замещение должностей {Замещение}
вывих - Смещение костей {Смещение}
выдел - Предоставление кому {Предоставление}
выдох - выталкивание воздуха {выталкивание}
выкидыш - прекращение беременности {прекращение}
выклинивание - утончение пласта {утончение}
выкрутасы - телодвижения па {телодвижения}
вымол - стадия помола {стадия}
вымысел - Создание воображения {Создание}
выползок - время линьки {время}
высотомер - приборов служащих {приборов}
выстрел - Взрыв заряда {Взрыв}
выхухоль - зверек отряда {зверек}
вычуры - узоры украшения {узоры}
вышибала - Служащий трактира {Служащий}
вьюрковые - птиц отряда {птиц}
вяза'нка - Связка (дров {Связка}
габарит - очертания предметов {очертания}
гадливость - Чувство отвращения {Чувство}
газ - Состояние вещества {Состояние}
газетчик - продавец газет {продавец}
газик - Автомобиль марки {Автомобиль}
газообмен - Процесс поглощения {Процесс}
гаитяне - Население Гаити {Население}
галлон - Мера объема {Мера}
галстук - Полоска ткани {Полоска}
галчонок - Птенец галки {Птенец}
гальванопластика - Осаждение металла {Осаждение}
гальванотехника - разделов электрохимии {разделов}
гам - гул голосов {гул}
гамаши - ткани чулок {ткани}
гамма - ряд каких {ряд}
гангрена - Омертвение какого {Омертвение}
гангстеризм - деятельности гангстеров {деятельности}
гардемарин - Звание воспитанника {Звание}
гарпунщик - Метатель гарпуна {Метатель}
гарт - Сплав свинца {Сплав}
гаршнеп - птица отряда {птица}
гарь - сгорании что {сгорании}
гачи - Половинки штанов {Половинки}
гвардеец - Военнослужащий гвардии {Военнослужащий}
гвардия - части войск {части}
гватемальцы - Население Гватемалы {Население}
гвинейцы - Население Гвинеи {Население}
гебраистика - Совокупность наук {Совокупность}
гегельянец - Последователь философии {Последователь}
гедонист - Последователь гедонизма {Последователь}
геккон - Пресмыкающееся отряда {Пресмыкающееся}
гелиогравюра - Способ воспроизведения {Способ}
гелиотехника - Отрасль науки {Отрасль}
гелиофизика - Раздел астрофизики {Раздел}
гемоглобин - вещество крови {вещество}
генеалогия - История рода {История}
генералитет - состав армии {состав}
гены - носители наследственности {носители}
география - Комплекс наук {Комплекс}
геологоразведка - исследование местности {исследование}
геометрия - Раздел математики {Раздел}
геофизика - Комплекс наук {Комплекс}
гепатит - заболеваний печени {заболеваний}
герб - знак государства {знак}
герлыга - посох пастуха {посох}
германистика - Совокупность наук {Совокупность}
гермафродитизм - Наличие признаков {Наличие}
гермошлем - шлем летчиков {шлем}
герпетология - Раздел зоологии {Раздел}
герц - Единица измерения {Единица}
гестаповец - Сотрудник гестапо {Сотрудник}
гигантизм - рост человека {рост}
гидрат - соединение окислов {соединение}
гидрид - соединение водорода {соединение}
гидроакустика - Раздел акустики {Раздел}
гидроаэромеханика - Раздел механики {Раздел}
гидрография - Раздел гидрологии {Раздел}
гидродинамика - Раздел гидромеханики {Раздел}
гидролокация - Определение местоположения {Определение}
гидрометаллургия - Извлечение металлов {Извлечение}
гидрометрия - Совокупность методов {Совокупность}
гидромеханизация - Способ производства {Способ}
гидромеханика - Раздел механики {Раздел}
гидроокиси - соединения окислов {соединения}
гидропоника - Выращивание растений {Выращивание}
гидростатика - Раздел гидромеханики {Раздел}
гидротехника - Отрасль науки {Отрасль}
гидроэнергетика - Раздел энергетики {Раздел}
гильдия - объединение купцов {объединение}
гимназист - Ученик гимназии {Ученик}
гиперемия - Прилив крови {Прилив}
гипертрофия - увеличение объема {увеличение}
гипоксия - Понижение содержания {Понижение}
гипотеза - объяснения каких {объяснения}
гипотермия - Понижение температуры {Понижение}
гипоцентр - точка очага {точка}
глава - Раздел какой {Раздел}
главковерх - Сокращение слов {Сокращение}
главком - Сокращение слова {Сокращение}
глаголь - буквы «Г {буквы}
глаз - Орган зрения {Орган}
гланды - Нёбные миндалины {Нёбные}
глаукома - Заболевание глаз {Заболевание}
гликоген - углевод животных {углевод}
глинистость - Наличие глины {Наличие}
глинище - Место добычи {Место}
глинозем - Окись алюминия {Окись}
глиптика - Искусство резьбы {Искусство}
глиссада - Траектория снижения {Траектория}
глиссандо - Прием игры {Прием}
глоток - движение питья {движение}
глухонемота - Отсутствие слуха {Отсутствие}
глухота - отсутствие слуха {отсутствие}
глянец - Блеск волос {Блеск}
гнездо - Место высева {Место}
гнездование - Выведение птенцов {Выведение}
гнездовье - Место гнездования {Место}
гнида - Яйцо вши {Яйцо}
гниение - Процесс разрушения {Процесс}
гнилокровие - заражение крови {заражение}
гнильца - степень гнилости {степень}
гнойник - Место скопления {Место}
гносеология - Теория познания {Теория}
гностик - Последователь гностицизма {Последователь}
говор - Звуки разговора {Звуки}
говядина - Мясо коровы {Мясо}
гогот - Крик гусей {Крик}
год - Единица летосчисления {Единица}
голография - Метод получения {Метод}
голод - ощущение потребности {ощущение}
голосование - Подача голосов {Подача}
голосоведение - Искусство сочетания {Искусство}
голубенок - Птенец голубя {Птенец}
голубка - Самка голубя {Самка}
голубятник - Любитель голубей {Любитель}
голяк - Человек ничего {Человек}
гомон - шум множества {шум}
гончарство - Ремесло гончара {Ремесло}
гордость - Чувство удовлетворения {Чувство}
горизонталь - плоскости горизонта {плоскости}
городничий - начальник города {начальник}
горожанин - Житель города {Житель}
гороно - Сокращение слов {Сокращение}
горообразование - Процесс образования {Процесс}
гороскоп - Таблица расположения {Таблица}
горошина - семя гороха {семя}
горчичник - Кусок бумаги {Кусок}
господство - влияние где {влияние}
господь - наименований бога {наименований}
государство - организация общества {организация}
градиент - Мера возрастания {Мера}
градус - Единица измерения {Единица}
гражданство - Принадлежность лица {Принадлежность}
грамзапись - Запись музыки {Запись}
грамм - Единица веса {Единица}
грамм-атом - Число граммов {Число}
грамм-молекула - Число граммов {Число}
грамматика - Раздел языкознания {Раздел}
грамота - сведения чтения {сведения}
гранула - комок какого {комок}
гранулема - разрастание клеток {разрастание}
грануляция - Придание какому {Придание}
грань - Линия раздела {Линия}
графология - Изучение почерка {Изучение}
грена - Яйца бабочки {Яйца}
гренки - ломтики хлеба {ломтики}
грибница - тело гриба {тело}
грива - волосы человека {волосы}
гримаса - искажение черт {искажение}
гроздь","гроздья - Скопление плодов {Скопление}
громовержец - Метатель грома {Метатель}
гротеск - прием шрифта {прием}
груда - количество каких {количество}
грузовладелец - Владелец груза {Владелец}
грузооборот - Количество грузов {Количество}
грузоподъемность - Способность механизма {Способность}
грузопоток - Движение грузов {Движение}
группа - человек предметов {человек}
групповод - Руководитель группы {Руководитель}
грусть - Чувство печали {Чувство}
грушовка - наливка яблони {наливка}
грюндер - основатель предприятий {основатель}
грюндерство - организация предприятий {организация}
губа - сушу заливов {сушу}
губернатор - Начальник губернии {Начальник}
губернаторство - Должность губернатора {Должность}
губернаторша - Жена губернатора {Жена}
гугеноты - протестантов (кальвинистов {протестантов}
гульден - единица Нидерландов {единица}
гуманизм - движение эпохи {движение}
гуманист - Представитель гуманизма {Представитель}
гунны - Кочевой народ {Кочевой}
гурийцы - группа грузин {группа}
гусеница - Личинка бабочки {Личинка}
гусятина - Мясо гуся {Мясо}
гюрза - змея рода {змея}
дагерротипия - Способ фотографирования {Способ}
дактилология - речи глухонемых {речи}
дактилоскопия - Раздел науки {Раздел}
далай-лама - правитель Тибета {правитель}
дальтонизм - Недостаток зрения {Недостаток}
дарвинист - Последователь дарвинизма {Последователь}
дата - время какого {время}
двадцатилетие - Промежуток времени {Промежуток}
двадцатипятилетие - Промежуток времени {Промежуток}
движенец - Работник службы {Работник}
движение - Изменение положения {Изменение}
двоеточие - Знак препинания {Знак}
двор - Участок земли {Участок}
двуполье - способ обработки {способ}
двурушничество - Поведение двурушника {Поведение}
двууглекислый - части углекислоты {части}
двухлетие - Промежуток времени {Промежуток}
двухсотлетие - Промежуток времени {Промежуток}
двухтысячелетие - Промежуток времени {Промежуток}
дебаты - Обсуждение какого {Обсуждение}
дебит - Количество жидкости {Количество}
дебют - выступление артиста {выступление}
девальвация - методов проведения {методов}
деверь - Брат мужа {Брат}
девичество - Период жизни {Период}
девчата - Девушки девочки {Девушки}
девяностолетие - Промежуток времени {Промежуток}
девятисотлетие - Промежуток времени {Промежуток}
дегазация - Обезвреживание местности {Обезвреживание}
дегенеративность - Наличие признаков {Наличие}
дегустация - Определение качества {Определение}
дед - Отец отца {Отец}
дедукция - Способ рассуждения {Способ}
дежа - Квашня тестомесилки {Квашня}
дежурство - Исполнение обязанностей {Исполнение}
дезидераты - Пожелания требования {Пожелания}
деист - Последователь деизма {Последователь}
дейтерий - Изотоп водорода {Изотоп}
декабристка - Жена декабриста {Жена}
декада - Промежуток времени {Промежуток}
декадент - Последователь декадентства {Последователь}
декалькомания - Способ изготовления {Способ}
деканат - управление факультета {управление}
деканство - Исполнение обязанностей {Исполнение}
деквалификация - Утрата квалификации {Утрата}
декларация - провозглашение каких {провозглашение}
декомпенсация - Нарушение компенсации {Нарушение}
декомпрессия - уменьшение давления {уменьшение}
декорация - изображение места {изображение}
делегация - Группа делегатов {Группа}
дельта - Устье реки {Устье}
делювий - Наносы отложения {Наносы}
делянка - Участок земли {Участок}
демилитаризация - Запрещение какому {Запрещение}
демократ - Сторонник демократии {Сторонник}
демократия - организации общества {организации}
демонстрант - Участник демонстрации {Участник}
демонтаж - Разборка оборудования {Разборка}
деморализация - Упадок дисциплины {Упадок}
демпинг - Продажа товаров {Продажа}
денатурация - Изменение свойств {Изменение}
дендрология - Раздел ботаники {Раздел}
денонсация - Заявление какого {Заявление}
деонтология - Раздел этики {Раздел}
департамент - отдел министерства {отдел}
депозитор - Вкладчик депозита {Вкладчик}
депутация - Группа уполномоченных {Группа}
дератизация - Система мер {Система}
деревенщина - жителе деревни {жителе}
деревина - Ствол дерева {Ствол}
деревообработка - Обработка дерева {Обработка}
деревяшка - Кусок дерева {Кусок}
дерматит - Воспаление кожи {Воспаление}
дерматоз - заболеваний кожи {заболеваний}
дерматология - Раздел медицины {Раздел}
дерн - слой почвы {слой}
десть - Единица счета {Единица}
десятерик - мера (счета {мера}
десятидневка - Промежуток времени {Промежуток}
десятилетие - Промежуток времени {Промежуток}
десяток - Единица счета {Единица}
детва - Личинки пчел {Личинки}
детерминист - Последователь детерминизма {Последователь}
детонация - воспламенение какого {воспламенение}
деторождение - Создание потомства {Создание}
детоубийство - Убийство ребенка {Убийство}
детоубийца - Убийца ребенка {Убийца}
детрит - масса продукт {масса}
дефиниция - определение какого {определение}
дефицит - Превышение расходов {Превышение}
дефляция - Сокращение количества {Сокращение}
деформация - Изменение размеров {Изменение}
децентрализация - Система управления {Система}
дециметр - Единица длины {Единица}
дешевизна - уровень цен {уровень}
деятельность - Работа каких {Работа}
джентльменство - Поведение джентльмена {Поведение}
джиу-джитсу - система приемов {система}
джоуль - Единица измерения {Единица}
джут - гибель скота {гибель}
дзеканье - Произношение звуков {Произношение}
диагноз - Определение болезни {Определение}
диагностика - Раздел медицины {Раздел}
диагональ - Отрезок прямой {Отрезок}
диалектология - Раздел языкознания {Раздел}
диаметр - Отрезок прямой {Отрезок}
диапазон - Объем звучания {Объем}
диатез - Предрасположение организма {Предрасположение}
диатермия - прогревание тканей {прогревание}
диета - режим питания {режим}
дизайн - проектирование предметов {проектирование}
дикобраз - Млекопитающее отряда {Млекопитающее}
диктор - Работник радио {Работник}
дина - Единица измерения {Единица}
динамика - Раздел механики {Раздел}
динамометрия - Измерение силы {Измерение}
династия - Ряд поколений {Ряд}
диоптрика - Раздел оптики {Раздел}
диоптрия - Единица измерения {Единица}
дипломатия - деятельность правительства {деятельность}
директор - Руководитель предприятия {Руководитель}
директорат - Коллегия директоров {Коллегия}
директриса - направление стрельбы {направление}
дирекция - орган предприятия {орган}
дирхем - единица Марокко {единица}
дисгармония - Нарушение гармонии {Нарушение}
дисквалификация - Лишение спортсмена {Лишение}
дискомфортность - Чувство неудобства {Чувство}
дисконт - Учет векселя {Учет}
дискредитация - Подрыв доверия {Подрыв}
дискуссия - обсуждение какого {обсуждение}
диспансеризация - Система мероприятий {Система}
диспетчеризация - Централизация контроля {Централизация}
диспозиция - План расположения {План}
диспропорция - Отсутствие пропорциональности {Отсутствие}
диссонанс - сочетание звуков {сочетание}
диссоциация - Распадение молекул {Распадение}
дистиллят - продукт перегонки {продукт}
дисциплина - членов какого {членов}
длина - Протяжение линии {Протяжение}
дневальство - Исполнение обязанностей {Исполнение}
добро - буквы «д {буквы}
добродетель - качество человека {качество}
добросердечие - Доброта характера {Доброта}
довод - Соображение какое {Соображение}
довольствие - снабжение военнослужащего {снабжение}
довольство - Чувство удовольствия {Чувство}
догматизм - Метод мышления {Метод}
догматика - Изложение догматов {Изложение}
дож - Титул главы {Титул}
дождинка - Капля дождя {Капля}
доза - количество какой {количество}
докторантура - Система подготовки {Система}
докторство - степень доктора {степень}
докторша - Женщина доктора {Женщина}
доктринерство - следование какой {следование}
документация - Обоснование чего {Обоснование}
доллар - единица США {единица}
домашность - хозяйство дела {хозяйство}
домен - владение феодала {владение}
домовладелец - Владелец дома {Владелец}
домочадцы - Члены семьи {Члены}
донесение - сообщение каких {сообщение}
доносительство - Занятие доносчика {Занятие}
допрос - Опрос обвиняемого {Опрос}
дорога - Полоса земли {Полоса}
дороговизна - уровень цен {уровень}
досье - Собрание документов {Собрание}
дот - точка (см {точка}
дофин - Титул наследника {Титул}
дравиды - группы народов {группы}
драматизм - Напряженность действия {Напряженность}
древонасаждение - Посадка деревьев {Посадка}
древостой - Совокупность деревьев {Совокупность}
дреколье - Дубины палки {Дубины}
дренаж - Осушение почвы {Осушение}
дровозаготовки - Заготовка дров {Заготовка}
дровосека - Участок леса {Участок}
дрожжевание - Способ увеличения {Способ}
дрожь - вздрагивание тела {вздрагивание}
дрозд - птица отряда {птица}
дружина - отряд воинов {отряд}
друза - Группа кристаллов {Группа}
дрязги - ссоры неприятности {ссоры}
дуалист - Последователь дуализма {Последователь}
дубление - Обработка (кож {Обработка}
дублет - экземпляр какой {экземпляр}
дубликат - экземпляр какого {экземпляр}
дуло - отверстие канала {отверстие}
дуновение - порыв ветра {порыв}
дуранда - Остатки семян {Остатки}
дутье - Подача воздуха {Подача}
духан - ресторана харчевни {ресторана}
духоборство - движение духоборов {движение}
душа - мир человека {мир}
дуэлист - Участник дуэли {Участник}
дыба - орудие пытки {орудие}
дыхание - Процесс поглощения {Процесс}
дьявольщина - стечении обстоятельств {стечении}
дьяк - писец в {писец}
дьяконица - Жена дьякона {Жена}
дьяконство - Сан дьякона {Сан}
дьячиха - Жена дьячка {Жена}
дэ - буквы «д {буквы}
дюйм - Мера длины {Мера}
дюралюминий - сплав алюминия {сплав}
дядька - Уничиж к {Уничиж}
дядя - Брат отца {Брат}
евангелист - церковью составителей {церковью}
египтология - Совокупность наук {Совокупность}
египтяне - Население Египта {Население}
единоборец - Участник единоборства {Участник}
единовластие - Сосредоточение власти {Сосредоточение}
единомыслие - образ мыслей {образ}
единонаследие - принцип наследования {принцип}
единоначалие - Система управления {Система}
единообразие - Единство вида {Единство}
ежевичник - Заросли ежевики {Заросли}
епископ - степень священства {степень}
еретик - Последователь ереси {Последователь}
ерш - Смесь водки {Смесь}
еры - буквы «ы {буквы}
естество - свойство чего {свойство}
естествознание - Система наук {Система}
ехидца - доля ехидства {доля}
жабры - Органы дыхания {Органы}
жаворонок - птица отряда {птица}
жадничанье - Проявление жадности {Проявление}
жакоб - стиля мебели {стиля}
жалоба - Выражение неудовольствия {Выражение}
жалость - Чувство соболезнования {Чувство}
жандармерия - полицейские войска {полицейские}
жар - степень тепла {степень}
жара - температура воздуха {температура}
жаргон - язык какой {язык}
жаровыносливость - Способность растений {Способность}
жатва - Уборка хлебов {Уборка}
железина - Кусок железа {Кусок}
железка - кусок железа {кусок}
железяка - Кусок железа {Кусок}
желтуха - окраска кожи {окраска}
желудок - Орган пищеварения {Орган}
желудь - Плод дуба {Плод}
жемчужина - зерно жемчуга {зерно}
женитьба - Вступление мужчины {Вступление}
женоубийца - Убийца жены {Убийца}
жеребенок - Детеныш лошади {Детеныш}
жеребец - Самец лошади {Самец}
жеребок - Шкурка жеребенка {Шкурка}
жеребьевка - Вынимание жребиев {Вынимание}
жеребятина - Мясо жеребенка {Мясо}
жерло - отверстие ствола {отверстие}
жертвоприношение - Обряд принесения {Обряд}
жестикуляция - Применение жестов {Применение}
жжение - ощущение жара {ощущение}
живопись - искусства картины {искусства}
живорождение - Способ воспроизведения {Способ}
живость - Быстрота движений {Быстрота}
жизнеобеспечение - Обеспечение условий {Обеспечение}
жизнеописание - Описание чьей {Описание}
жизнепонимание - Совокупность взглядов {Совокупность}
жизнь - движения материи {движения}
жилкование - Расположение жилок {Расположение}
жим - Поднятие штанги {Поднятие}
жирномолочность - Содержание жира {Содержание}
жирность - Степень содержания {Степень}
жировка - Кормежка птицы {Кормежка}
жирондист - Член жиронды {Член}
жироприказ - распоряжение вкладчика {распоряжение}
жиротопление - Получение жира {Получение}
житье - Условия существования {Условия}
жмыхи - Остатки семян {Остатки}
жонглерство - Искусство жонглера {Искусство}
жор - клев рыбы {клев}
жречество - Занятия обязанности {Занятия}
журавленок - Птенец журавля {Птенец}
журавль - птица отряда {птица}
журфикс - Прием гостей {Прием}
жюри - Группа специалистов {Группа}
за'пах - Свойство предметов {Свойство}
забастовка - прекращение работы {прекращение}
забастовщик - Участник забастовки {Участник}
забвение - Утрата воспоминаний {Утрата}
забой - ходе работ {ходе}
заболеваемость - количество заболеваний {количество}
заболонь - слой древесины {слой}
забытье - потеря сознания {потеря}
завеса - кусок ткани {кусок}
зависть - Чувство досады {Чувство}
завиток - прядь волос {прядь}
завихрение - Образование вихрей {Образование}
завсегдатай - посетитель чего {посетитель}
загадка - описание какого {описание}
загар - цвет кожи {цвет}
заговор - Набор слов {Набор}
загонщик - Участник облавы {Участник}
загс - Отдел исполкома {Отдел}
задача - выполнения разрешения {выполнения}
задачник - Сборник задач {Сборник}
задира - Зачинщик ссор {Зачинщик}
задолженность - Наличие долга {Наличие}
задумчивость - Состояние размышления {Состояние}
заем - Взятие (денег {Взятие}
зажин - Начало жатвы {Начало}
зажор","зажора - Скопление льда {Скопление}
зазнайство - Поведение того {Поведение}
заиление - Заполнение русла {Заполнение}
займодержатель - Владелец облигаций {Владелец}
зайчатина - Мясо зайца {Мясо}
зайчиха - Самка зайца {Самка}
зайчонок - Детеныш зайца {Детеныш}
заказ - Запрет запрещение {Запрет}
закись - степень окисления {степень}
законник - Знаток законов {Знаток}
законоведение - Совокупность сведений {Совокупность}
законоположение - Совокупность законов {Совокупность}
законопроект - Проект закона {Проект}
законоучитель - Преподаватель закона {Преподаватель}
закраина - Край чего {Край}
закрутасы - линии петли {линии}
залежка - Лежбище моржей {Лежбище}
залив - звуки лая {звуки}
залог - Категория глагола {Категория}
залог - Обеспечение каким {Обеспечение}
залужение - Создание луга {Создание}
залысина - участок головы {участок}
замашка - особь конопли {особь}
заменитель - Материал продукт {Материал}
заместительство - исполнение обязанностей {исполнение}
замор - гибель рыбы {гибель}
замполит - Заместитель командира {Заместитель}
замужество - Вступление (женщины {Вступление}
замысел - план действий {план}
занавеска - Полотнище ткани {Полотнище}
заноза - кусочек дерева {кусочек}
запад - стран света {стран}
западник - Сторонник западничества {Сторонник}
запал - Повреждение зерна {Повреждение}
запас - количество чего {количество}
запев - Начало былины {Начало}
записка - Листок бумаги {Листок}
заплата - Кусок какого {Кусок}
заплачка - Причитание невесты {Причитание}
запоздание - Несвоевременность явки {Несвоевременность}
заполярье - Области пространства {Области}
запор - задержка стула {задержка}
запыленность - Насыщенность воздуха {Насыщенность}
запятая - Знак препинания {Знак}
зарево - Отсвет пожара {Отсвет}
зарегулирование - Введение регулярности {Введение}
заря - освещение горизонта {освещение}
заседание - Собрание членов {Собрание}
застенок - Место пыток {Место}
застой - Отсутствие развития {Отсутствие}
застреха - край крыши {край}
засуха - отсутствие дождей {отсутствие}
затворничество - образ жизни {образ}
затейник - затеям человек {затеям}
затейничество - Организация забав {Организация}
затишье - прекращение ветра {прекращение}
затоваренность - Скопление товара {Скопление}
зачес - Расположение волос {Расположение}
зачин - Начало былины {Начало}
заяц - зверек отряда {зверек}
звездопад - падение метеоров {падение}
зверенок - Детеныш зверя {Детеныш}
звереныш - Детеныш зверя {Детеныш}
звуковоспроизведение - Воспроизведение звукозаписи {Воспроизведение}
звукоизоляция - Совокупность устройств {Совокупность}
звукометрия - Способ определения {Способ}
звукопроводность - Способность тела {Способность}
звукосочетание - Сочетание звуков {Сочетание}
здоровье - Состояние организма {Состояние}
зейгерование - Способ разделения {Способ}
зеленщик - Продавец зелени {Продавец}
зеленя - всходы хлебов {всходы}
землепользование - Порядок условия {Порядок}
землечерпание - Выемка грунта {Выемка}
земля - буквы «з {буквы}
земляне - жителей планеты {жителей}
земляничина - ягода земляники {ягода}
зензубель - инструмент род {инструмент}
зенит - точка развития {точка}
зеница - Зрачок глаз {Зрачок}
зеркало - поверхность чего {поверхность}
зернопогрузчик - машина зернохранилищ {машина}
зима - время года {время}
зимовье - Проведение зимы {Проведение}
зимогор - Босяк бродяга {Босяк}
злоба - Чувство недоброжелательства {Чувство}
зложелательство - Желание зла {Желание}
злотый - единица Польши {единица}
знание - Обладание какими {Обладание}
значимость - Наличие значения {Наличие}
золовка - Сестра мужа {Сестра}
золотник - мера веса {мера}
золоудаление - Удаление золы {Удаление}
золоулавливание - Улавливание золы {Улавливание}
золь - частицы какого {частицы}
зольность - Содержание золы {Содержание}
зоопсихология - Отрасль психологии {Отрасль}
зэ - буквы «з {буквы}
зябь - вспашка поля {вспашка}
ибис - Птица отряда {Птица}
ивняк - кустарник заросли {кустарник}
иволга - птица отряда {птица}
иврит - язык Израиля {язык}
иглотерапия - Метод лечения {Метод}
игрок - Участник какой {Участник}
идеология - Система идей {Система}
идиш - Язык части {Язык}
иена - единица Японии {единица}
иероглифика - Совокупность знаков {Совокупность}
иждивение - Деньги средства {Деньги}
избоина - Остатки семян {Остатки}
извоз - Перевозка грузов {Перевозка}
издольщина - аренды земли {аренды}
изжога - Ощущение жжения {Ощущение}
излишек - удовлетворении потребности {удовлетворении}
излишество - количество чего {количество}
изложница - отливки металла {отливки}
изнанка - сторона чего {сторона}
изножье - место постели {место}
износостойкость - Способность (материала {Способность}
изобретательство - Деятельность изобретателя {Деятельность}
изография - воспроизведение письмен {воспроизведение}
изоляционист - Сторонник изоляционизма {Сторонник}
изоморфизм - Способность веществ {Способность}
изоморфный - строением кристаллов {строением}
израильтяне - племен Израиля {племен}
израстание - развитие растений {развитие}
изреженность - густота всходов {густота}
изъязвление - Образование язв {Образование}
изюм - ягоды винограда {ягоды}
изюмина - ягода изюма {ягода}
икона - изображение бога {изображение}
иконоборец - Сторонник иконоборчества {Сторонник}
икринка - зернышко икры {зернышко}
икрометание - Метание икры {Метание}
икс - конца буквы {конца}
иллюзионизм - Показ фокусов {Показ}
иллюзия - восприятие действительности {восприятие}
иллюминация - освещение зданий {освещение}
ильмовник - Заросли ильма {Заросли}
имажинист - Последователь имажинизма {Последователь}
имбирь - растение корневища {растение}
имение - владение помещика {владение}
имеретины","имеретинцы - группа грузин {группа}
иммунитет - Невосприимчивость организма {Невосприимчивость}
императрица - Жена императора {Жена}
империализм - стадия капитализма {стадия}
имперфект - время глагола {время}
импрессионист - Последователь импрессионизма {Последователь}
инвазия - Заражение человека {Заражение}
инвар - Сплав железа {Сплав}
инвариантность - Свойство величин {Свойство}
инвентарь - Совокупность предметов {Совокупность}
индейка - птица отряда {птица}
индетерминист - Последователь индетерминизма {Последователь}
индийцы - Население Индии {Население}
индология - Совокупность наук {Совокупность}
индонезийцы - Население Индонезии {Население}
индуизм - религий мира {религий}
индукция - Способ рассуждения {Способ}
индустриализация - Процесс создания {Процесс}
индусы - Последователи индуизма {Последователи}
индюк - Самец индейки {Самец}
индюшатина - Мясо индюшки {Мясо}
индюшонок - Птенец индюшки {Птенец}
инерция - Свойство тела {Свойство}
инженерша - Жена инженера {Жена}
инжир - дерево смоква {дерево}
инициалы - буквы имени {буквы}
инкассо - операция получения {операция}
инквизитор - Судья инквизиции {Судья}
инкубация - период болезни {период}
иннервация - Снабжение органов {Снабжение}
инобытие - бытия существования {бытия}
иноходь - Способ бега {Способ}
инспекторство - Должность инспектора {Должность}
инструментарий - Совокупность инструментов {Совокупность}
интеллект - способности человека {способности}
интервент - Участник интервенции {Участник}
интервенционист - Сторонник интервенции {Сторонник}
интервью - печати радио {печати}
интернатура - стажировки врачей {стажировки}
интернационализм - солидарность рабочих {солидарность}
интернационалист - Сторонник интернационализма {Сторонник}
интерпелляция - запроса депутата {запроса}
интоксикация - Отравление организма {Отравление}
интроскопия - наблюдение объектов {наблюдение}
интроспекция - наблюдение состояний {наблюдение}
интуитивист - Сторонник интуитивизма {Сторонник}
инфант - Титул принца {Титул}
инфаркт - Очаг омертвения {Очаг}
инфильтрация - Просачивание тканей {Просачивание}
инфицирование - Внесение инфекции {Внесение}
ионизация - Образование ионов {Образование}
иорданцы - Население Иордании {Население}
иракцы - Население Ирака {Население}
иранистика - Совокупность наук {Совокупность}
иранцы - Население Ирана {Население}
ириска - конфета ири {конфета}
иррадиация - увеличение размеров {увеличение}
искра - частица чего {частица}
искусство - воспроизведение действительности {воспроизведение}
ислам - религий мира {религий}
исламизм - система ислама {система}
испаритель - установок служащих {установок}
исповедь - Обряд покаяния {Обряд}
исполнительство - Исполнение какого {Исполнение}
исправница - Жена исправника {Жена}
испуг - чувство страха {чувство}
истерика - Припадок истерии {Припадок}
истома - Чувство усталости {Чувство}
ихтиология - Раздел зоологии {Раздел}
ишак - Помесь лошади {Помесь}
йеменцы - Население Йемена {Население}
йог - Последователь йоги {Последователь}
йодоформ - Препарат йода {Препарат}
кабанина - Мясо кабана {Мясо}
кабатчик - Содержатель кабака {Содержатель}
кабачок - растение род {растение}
кабельтов - мера длины {мера}
кавалерист - Военнослужащий кавалерии {Военнослужащий}
кавалькада - Группа всадников {Группа}
кавыка - знака краткости {знака}
каган - Титул главы {Титул}
кагат - Куча картофеля {Куча}
кагатирование - Устройство кагатов {Устройство}
кадастр - Опись чего {Опись}
кадры - состав работников {состав}
казенщина - формализм рутина {формализм}
казначей - Хранитель денег {Хранитель}
казнокрадство - Обкрадывание казны {Обкрадывание}
казнь - мера наказания {мера}
какавелла - Шелуха семян {Шелуха}
кал - Содержимое кишечника {Содержимое}
календы - день месяца {день}
кали - окиси калия {окиси}
калибр - Диаметр пули {Диаметр}
калинник - Заросли калины {Заросли}
калиф - написание слова {написание}
калорийность - Количество энергии {Количество}
калориметрия - Совокупность методов {Совокупность}
калория - единица измерения {единица}
калым - народов стран {народов}
калькуляция - Вычисление себестоимости {Вычисление}
камаринская","камаринский - плясовой песни {плясовой}
каменобоец - разбиванием камня {разбиванием}
камнерез - Мастер резьбы {Мастер}
кампанейщина - Отсутствие планомерности {Отсутствие}
кампания - Совокупность операций {Совокупность}
камуфлет - взрыв мины {взрыв}
камуфляж - Способ маскировки {Способ}
камчадалы - населения Камчатки {населения}
камышевка","камышовка - птица отряда {птица}
камышина - Стебель камыша {Стебель}
канадцы - Население Канады {Население}
канализация - Система труб {Система}
кандела - единица силы {единица}
каникулы - Перерыв занятий {Перерыв}
канонир - Рядовой артиллерии {Рядовой}
кантор - Певчий хора {Певчий}
канцелярист - Служащий канцелярии {Служащий}
канцелярия - Отдел учреждения {Отдел}
капель - Падение капель {Падение}
капельмейстер - Дирижер военного {Дирижер}
капер - судно противника {судно}
капиллярность - Способность жидкости {Способность}
капитулянтство - Поведение капитулянта {Поведение}
капля - частица жидкости {частица}
каптерка - Склад имущества {Склад}
капустница - бабочка гусеницы {бабочка}
карабинер - карабином солдат {карабином}
караван - Группа судов {Группа}
карамелька - конфета карамели {конфета}
карандаш - палочка графита {палочка}
карантин - изоляция больных {изоляция}
карат - Мера веса {Мера}
каратэ - система самозащиты {система}
караул - охрана стража {охрана}
карбид - Соединение углерода {Соединение}
карбонизация - Насыщение какого {Насыщение}
карборунд - Соединение кремния {Соединение}
кардиограмма - изображение работы {изображение}
кардиография - Запись работы {Запись}
кардиология - Раздел медицины {Раздел}
каре - Построение пехоты {Построение}
кариокинез - способов размножения {способов}
карканье - Крик вороны {Крик}
каркас - Остов какого {Остов}
карст - Совокупность явлений {Совокупность}
картвелы - Самоназвание грузин {Самоназвание}
картина - Произведение живописи {Произведение}
картотека - собрание карточек {собрание}
картофелина - клубень картофеля {клубень}
карточка - листок билета {листок}
каскадер - Исполнитель номера {Исполнитель}
кассация - Способ обжалования {Способ}
кассир - Работник кассы {Работник}
каталепсия - Состояние неподвижности {Состояние}
катаракта - Помутнение хрусталика {Помутнение}
катетеризация - Введение катетера {Введение}
католикос - Титул главы {Титул}
каустик - гидроокиси натрия {гидроокиси}
кахетинцы - группа грузин {группа}
кацавейка - одежда род {одежда}
качка - Колебание судна {Колебание}
кваканье - Крик лягушки {Крик}
квант - количество энергии {количество}
квартиросъемщик - Съемщик квартиры {Съемщик}
квартирохозяин - Владелец квартиры {Владелец}
квасцы - солей (марганца {солей}
квиетист - Последователь квиетизма {Последователь}
кедровка - птица отряда {птица}
кельты - Группа племен {Группа}
келья - Жилище монаха {Жилище}
кенийцы - Население Кении {Население}
керн - Образец породы {Образец}
керогаз - прибор род {прибор}
кетмень - Орудие типа {Орудие}
ки'са - кличка кошки {кличка}
кибернетизация - Введение методов {Введение}
кибитка - повозка (тарантаса {повозка}
киловатт - Единица измерения {Единица}
киловатт-час - единица измерения {единица}
килограмм - Единица веса {Единица}
километр - Единица длины {Единица}
кильватер - Струя воды {Струя}
кинематографист - Работник кинематографии {Работник}
кинематография - Искусство съемки {Искусство}
кинодокументалистика - Область кинематографии {Область}
кинодраматургия - Совокупность киносценариев {Совокупность}
кинолюбительство - Занятие кинолюбителей {Занятие}
кинопрокат - Выпуск кинофильмов {Выпуск}
кинопромышленность - Отрасль промышленности {Отрасль}
кинорежиссер - Постановщик фильма {Постановщик}
киносеть - Совокупность кинотеатров {Совокупность}
киноустановка - Совокупность оборудования {Совокупность}
кинофестиваль - Показ кинофильмов {Показ}
кинофильм - Произведение кинематографии {Произведение}
киношник - Работник кинематографии {Работник}
киприоты - Население Кипра {Население}
киска - кличка кошки {кличка}
кислотность - Степень содержания {Степень}
китаеведение - Совокупность наук {Совокупность}
кишечник - Совокупность кишок {Совокупность}
клавир - инструментов (клавикордов {инструментов}
кладбище - Место скопления {Место}
кладовщик - Работник кладовой {Работник}
кладь - Поклажа груз {Поклажа}
клака - группа людей {группа}
клаксон - гудок автомобиля {гудок}
клан - община род {община}
класс - Разряд судов {Разряд}
классика - произведения литературы {произведения}
клерикал - Сторонник клерикализма {Сторонник}
клетка - единица строения {единица}
клецки - Кусочки теста {Кусочки}
клеш - покрой юбки {покрой}
климактерий - Период угасания {Период}
климат - режим погоды {режим}
клин - кусок дерева {кусок}
клинкер - влаги кирпича {влаги}
клинопись - Способ письма {Способ}
клирик - Член клира {Член}
клише - воспроизведения иллюстраций {воспроизведения}
клохтанье - крик курицы {крик}
клубнеплоды - Группа растений {Группа}
клубника - растение рода {растение}
клюв - окончание рта {окончание}
клюквина - ягода клюквы {ягода}
кляп - Кусок дерева {Кусок}
клятвопреступление - Нарушение клятвы {Нарушение}
книга - Произведение печати {Произведение}
книгоед - Насекомое отряда {Насекомое}
книгоноша - Продавец книг {Продавец}
книгопечатание - печатание текста {печатание}
книгочей - Любитель чтения {Любитель}
кнутовище - Рукоятка кнута {Рукоятка}
княгиня - Жена князя {Жена}
княжата - сыновья князя {сыновья}
княжич - сын князя {сын}
княжна - дочь князя {дочь}
князек - сын князя {сын}
князь - Предводитель войска {Предводитель}
коагуляция - Процесс слипания {Процесс}
кобель - Самец собаки {Самец}
кобыла - Самка лошади {Самка}
кобылятина - Мясо кобылы {Мясо}
когорта - Отряд войска {Отряд}
кодекс - свод законов {свод}
кожа - покров тела {покров}
кожанка - куртка пальто {куртка}
кожимит - заменителей кожи {заменителей}
кожура - оболочка плода {оболочка}
козел - Самец козы {Самец}
козленок - Детеныш козы {Детеныш}
козлятина - Мясо козы {Мясо}
козоводство - Разведение коз {Разведение}
кокетство - Поведение того {Поведение}
коксохимия - Область химии {Область}
колер - цвет краски {цвет}
коллаборационизм - сотрудничество коллаборационистов {сотрудничество}
коллектив - Группа лиц {Группа}
коллективист - Сторонник коллективизма {Сторонник}
коллекционер - Собиратель коллекции {Собиратель}
коллекционерство - Собирание коллекций {Собирание}
коллоквиум - Беседа преподавателя {Беседа}
колониализм - порабощение стран {порабощение}
колонист - Житель колонии {Житель}
колоннада - Ряд колонн {Ряд}
колонцифра - номер страницы {номер}
колоратура - пассажи рулады {пассажи}
колос - Соцветие большинства {Соцветие}
колошение - Образование колосьев {Образование}
колтун - Болезнь кожи {Болезнь}
колумбарий - Хранилище урн {Хранилище}
колумбийцы - население Колумбии {население}
колхозник - Член колхоза {Член}
ком - Кусок какого {Кусок}
команда - приказ командира {приказ}
командир - Начальник звена {Начальник}
командирша - Жена командира {Жена}
комбайнер - Водитель комбайна {Водитель}
комбайностроение - Отрасль машиностроения {Отрасль}
комбат - Командир батареи {Командир}
комбриг - Командир бригады {Командир}
комдив - Командир дивизии {Командир}
комендор - Звание матроса {Звание}
комизм - сторона чего {сторона}
комиссия - Группа лиц {Группа}
комитетчик - Член комитета {Член}
коммивояжер - агент какой {агент}
коммуна - Коллектив лиц {Коллектив}
коммуникация - Путь сообщения {Путь}
коммутация - Изменение соединений {Изменение}
компенсатор - приборов устройств {приборов}
компетенция - Область вопросов {Область}
компиляция - Составление каких {Составление}
комплект - набор каких {набор}
компрессия - Сжатие воздуха {Сжатие}
комсомол - союз молодежи {союз}
комсомолец - Член комсомола {Член}
конвекция - Перенос теплоты {Перенос}
конвергенция - Совпадение каких {Совпадение}
конверсия - Изменение условий {Изменение}
конвой - Группа кораблей {Группа}
конгломерат - соединение чего {соединение}
конголезцы - Население Конго {Население}
конгрессмен - Член конгресса {Член}
коневодство - Отрасль животноводства {Отрасль}
конечности - Руки ноги {Руки}
конина - Мясо лошади {Мясо}
конклав - Собрание кардиналов {Собрание}
конкурсант - Участник конкурса {Участник}
коннозаводство - Разведение лошадей {Разведение}
коногон - Погонщик лошади {Погонщик}
конокрадство - Кража лошадей {Кража}
коноплеводство - Возделывание конопли {Возделывание}
конопляник - Участок земли {Участок}
консерваторец - Студент консерватории {Студент}
консилиум - Совещание врачей {Совещание}
консистенция - Степень подвижности {Степень}
конституция - закон государства {закон}
конструктивист - Последователь конструктивизма {Последователь}
консультация - Обсуждение какого {Обсуждение}
контингент - Совокупность людей {Совокупность}
континент - частей суши {частей}
контокоррент - счет операции {счет}
контора - отделов предприятий {отделов}
контрактация - Заключение контракта {Заключение}
контрапункт - Искусство сочетания {Искусство}
контраст - противоположность живописи {противоположность}
контрданс - танец (род {танец}
контрразведчик - Работник контрразведки {Работник}
контрудар - удар войск {удар}
контрфорс - выступ стены {выступ}
контры - неудовольствия ссоры {неудовольствия}
контур - очертание предмета {очертание}
конфедерат - Участник конфедерации {Участник}
конфедерация - Союз государств {Союз}
конфискация - изъятие денег {изъятие}
конфуз - Состояние смущения {Состояние}
концертмейстер - Руководитель группы {Руководитель}
концессионер - Владелец концессии {Владелец}
конъюнктива - оболочка глаза {оболочка}
конъюнктивит - Воспаление конъюнктивы {Воспаление}
кооперация - организации труда {организации}
кооптация - Пополнение состава {Пополнение}
копилка - ящичек кружка {ящичек}
копна - Куча сена {Куча}
копотня - исполнение чего {исполнение}
коптитель - Коптитель неба# {Коптитель}
копулировка - способов прививки {способов}
корабельщик - Владелец корабля {Владелец}
кораблекрушение - Гибель корабля {Гибель}
коралл - животное род {животное}
кордебалет - Артисты балета {Артисты}
кордон - пост отрядов {пост}
корифей - Руководитель хора {Руководитель}
корка - слой коры {слой}
корм - Пища животных {Пища}
кормило - Руль судна {Руль}
корненожки - животных (амеб {животных}
корнеплоды - растений (свеклы {растений}
королевич - Сын короля {Сын}
королевна - Дочь короля {Дочь}
король - Титул монарха {Титул}
коронация - церемония возложения {церемония}
коростель - Птица с {Птица}
корпия - ткани нитки {ткани}
корпорация - Группа лиц {Группа}
корпускула - Частица материи {Частица}
корректировка - Внесение поправок {Внесение}
корректор - Работник типографии {Работник}
корректура - Исправление ошибок {Исправление}
коррида - Бой тореадора {Бой}
коррозия - Разрушение металлов {Разрушение}
коррупция - Подкупность продажность {Подкупность}
корчи - сокращения мышц {сокращения}
космогония - Раздел астрономии {Раздел}
космография - Описание Вселенной {Описание}
космодром - Комплекс сооружений {Комплекс}
космы - Пряди волос {Пряди}
косоглазие - Болезнь глаз {Болезнь}
косогор - Склон горы {Склон}
косолапость - Искривление стопы {Искривление}
косорукость - положение кисти {положение}
косослой - Порок строения {Порок}
костер - куча дров {куча}
косторез - Мастер резьбы {Мастер}
костюмер - Работник театра {Работник}
костяк - Остов человека {Остов}
костянка - Плод растений {Плод}
косушка - Полбутылки водки {Полбутылки}
косяк - Гурт кобыл {Гурт}
кот - Самец кошки {Самец}
котенок - Детеныш кошки {Детеныш}
кофе - дерево (зерна {дерево}
кочан - Головка капусты {Головка}
кочерыжка - стебель кочана {стебель}
кош - жилище кочевников {жилище}
кошатник - Любитель кошек {Любитель}
кошель - мешок сума {мешок}
краболов - Ловец крабов {Ловец}
краеведение - Совокупность знаний {Совокупность}
краешек - полоска чего {полоска}
кража - хищение чьей {хищение}
край - линия какого {линия}
крайность - степень чего {степень}
краниометрия - Измерение черепа {Измерение}
крапивник - Заросли крапивы {Заросли}
краса - Красота ","Прелести {Красота}
краюха - ломоть хлеба {ломоть}
креди'т - Предоставление товаров {Предоставление}
кредо - Символ веры {Символ}
крекинг - Переработка нефти {Переработка}
кремация - Сжигание трупов {Сжигание}
кремнезем - двуокиси кремния {двуокиси}
крен - наклон судна {наклон}
крепыш - телосложения человек {телосложения}
крестины - Обряд крещения {Обряд}
крестьянство - Класс крестьян {Класс}
крик - звук голоса {звук}
крикса - плач ребенка {плач}
криминал - признаки преступления {признаки}
криница - Колодец родник {Колодец}
криптография - система изменения {система}
кристаллизация - Процесс образования {Процесс}
крица - масса железа {масса}
кроветворение - Процесс образования {Процесс}
кровинка - Капля крови {Капля}
кровоизлияние - Скопление крови {Скопление}
кровообращение - движение крови {движение}
кровотечение - Истечение крови {Истечение}
кровохарканье - Выделение крови {Выделение}
кроки - Набросок рисунка {Набросок}
кролиководство - Разведение кроликов {Разведение}
крольчатина - Мясо кролика {Мясо}
крольчиха - Самка кролика {Самка}
крольчонок - Детеныш кролика {Детеныш}
крот - Млекопитающее отряда {Млекопитающее}
крохотка - количество чего {количество}
кружковец - Член кружка {Член}
крупа - Продукт питания {Продукт}
крупинка - зерно крупы {зерно}
крушинник - Заросли крушины {Заросли}
крыжовник - кустарник ягоды {кустарник}
крыло - Орган летания {Орган}
крысенок - Детеныш крысы {Детеныш}
крючкотворство - использование мелочей {использование}
кряканье - Крик утки {Крик}
кубатура - Объем чего {Объем}
кубист - Последователь кубизма {Последователь}
кудахтанье - крик курицы {крик}
кудель - Волокно льна {Волокно}
кудряшки - Завитки кольца {Завитки}
кузька - вредитель зерновых {вредитель}
кукареканье - Крик петуха {Крик}
куклуксклановец - Член ку-клукс-клана {Член}
кукование - Крик кукушки {Крик}
кукушонок - Птенец кукушки {Птенец}
кулак - Кисть руки {Кисть}
кулачество - Класс кулаков {Класс}
кулачье - Кулаки (см {Кулаки}
кулинария - Искусство приготовления {Искусство}
кулиса - части декорации {части}
кулон - Единица измерения {Единица}
культуртрегер - Носитель культуры {Носитель}
культуртрегерство - Образ действий {Образ}
кумуляция - Усиление действия {Усиление}
купидон - бог любви {бог}
куплет - строфа стихотворения {строфа}
купчиха - Жена купца {Жена}
кураторство - Занятие куратора {Занятие}
курица - птица отряда {птица}
курлыканье - Крик журавля {Крик}
куроводство - Разведение кур {Разведение}
куропатка - птица отряда {птица}
курортология - Раздел медицины {Раздел}
курпей - Овчина ягненка {Овчина}
курс - Направление движения {Направление}
курсист - Слушатель курсов {Слушатель}
курфюрстина - Жена курфюрста {Жена}
курятина - Мясо курицы {Мясо}
кустарничество - Занятие кустаря {Занятие}
куча - количество каких {количество}
лабазник - Владелец лабаза {Владелец}
лаборант - сотрудник лаборатории {сотрудник}
лава - масса (людей {масса}
лавина - Масса снега {Масса}
лагерь - стоянка войск {стоянка}
ладонь - сторона кисти {сторона}
лазы - группа грузин {группа}
лак - Раствор смол {Раствор}
лактация - Отделение молока {Отделение}
лакцы","лаки - народов Дагестана {народов}
ламаист - Последователь ламаизма {Последователь}
ламаркизм - теория развития {теория}
ламентации - Сетования жалобы {Сетования}
ланка - Самка оленя {Самка}
ланцетник - животное типа {животное}
лаосцы - Население Лаоса {Население}
лапник - Ветви елей {Ветви}
ларингология - Раздел оториноларингологии {Раздел}
лары - души предков {души}
ласка - Выражение любви {Выражение}
латания - растение рода {растение}
латекс - сок растений {сок}
латка - Посуда род {Посуда}
латунь - Сплав меди {Сплав}
ле'та - река забвения {река}
лебеденок - Птенец лебедя {Птенец}
лебедка - Самка лебедя {Самка}
лев - единица Болгарии {единица}
левкас - Смесь алебастра {Смесь}
левобережье - берег реки {берег}
легионер - Воин солдат {Воин}
легислатура - период деятельности {период}
легкие - Орган дыхания {Орган}
леди - Жена лорда {Жена}
ледни'к - скопление масс {скопление}
ледозащита - Система мероприятий {Система}
ледоруб - топорика кирки {топорика}
ледостав - Замерзание рек {Замерзание}
ледоход - Движение льда {Движение}
ледышка - Кусочек льда {Кусочек}
лей","лея - единица Румынии {единица}
лейкемия - Заболевание крови {Заболевание}
лейкоцитоз - Увеличение числа {Увеличение}
лейкоциты - клетки крови {клетки}
лек - единица Албании {единица}
лекарша - Жена лекаря {Жена}
лексика - Совокупность слов {Совокупность}
лексикология - Раздел языкознания {Раздел}
лекция - изложение предмета {изложение}
лемуры - души умерших {души}
ленд-лиз - Система передачи {Система}
ленинец - Последователь ленинизма {Последователь}
ленинизм - Учение В {Учение}
лента - полоса ткани {полоса}
лень - Отсутствие желания {Отсутствие}
лепет - речь (ребенка {речь}
лесничество - Участок леса {Участок}
лесоведение - Отрасль знаний {Отрасль}
лесоводство - Отрасль растениеводства {Отрасль}
лесозаготовки - заготовка леса {заготовка}
лесоматериалы - материалы (бревна {материалы}
лесонасаждение - разведение лесов {разведение}
лесопосадка - Посадка леса {Посадка}
лесоразведение - выращивание леса {выращивание}
лесосека - Участок леса {Участок}
лесосплав - Сплав леса {Сплав}
лесоустройство - Система мероприятий {Система}
лесохимия - Область знаний {Область}
лесоэксплуатация - Заготовка древесины {Заготовка}
лесть - восхваление кого {восхваление}
лето - время года {время}
летописание - Составление летописей {Составление}
летописец - Составитель летописи {Составитель}
летопись - запись произведений {запись}
летосчисление - Система определения {Система}
летчик - Водитель самолета {Водитель}
леший - дух леса {дух}
либерал - Сторонник либерализма {Сторонник}
либреттист - Автор либретто {Автор}
ливер - пищу внутренности {пищу}
лигроин - продуктов перегонки {продуктов}
лидерство - Положение обязанности {Положение}
лизис - разрешение болезни {разрешение}
лизоблюдство - Поведение лизоблюда {Поведение}
ликбез - Ликвидация неграмотности {Ликвидация}
ликвидация - Прекращение деятельности {Прекращение}
лиман - водами моря {водами}
лимитация - Установление лимита {Установление}
лимонник - кустарник ягоды {кустарник}
лира - единица Италии {единица}
лирохвост - Птица отряда {Птица}
лис - Самец лисицы {Самец}
лисенок - Детеныш лисицы {Детеныш}
лисовин - Самец лисы {Самец}
листва - Листья растения {Листья}
листовертки - бабочек гусеницы {бабочек}
листопад - Опадание листьев {Опадание}
литераторство - Занятие литератора {Занятие}
литография - способ печати {способ}
литосфера - сфера Земли {сфера}
литр - Единица объема {Единица}
литраж - Вместимость какого {Вместимость}
лихач - человек удалец {человек}
лихолетье - Пора смут {Пора}
лицеист - Воспитанник лицея {Воспитанник}
лицемерие - Несоответствие слов {Несоответствие}
личина - Маска манеры {Маска}
личинка - Стадия развития {Стадия}
личность - Совокупность свойств {Совокупность}
ловеласничество - Поведение ловеласа {Поведение}
логарифм - Показатель степени {Показатель}
логопатия - Расстройство речи {Расстройство}
лодыжка - бокам ноги {бокам}
лозняк - кустарник заросли {кустарник}
локаут - увольнение рабочих {увольнение}
локон - прядь волос {прядь}
локоть - Место сгиба {Место}
лопасть - конец чего {конец}
лорд-канцлер - Председатель палаты {Председатель}
лорд-мэр - Глава муниципалитета {Глава}
лордство - Звание лорда {Звание}
лосенок - Детеныш лося {Детеныш}
лосиха - Самка лося {Самка}
лососина - Мясо лосося {Мясо}
лосятина - Мясо лося {Мясо}
лот - мера веса {мера}
лотерея - Розыгрыш вещей {Розыгрыш}
лох - самца семги {самца}
лохань - посуда стирки {посуда}
лохмы - Пряди волос {Пряди}
лошадник - Любитель лошадей {Любитель}
лошак - Помесь жеребца {Помесь}
луб - ткань льна {ткань}
луг - Пространство земли {Пространство}
луговедение - Раздел геоботаники {Раздел}
лука - поворот реки {поворот}
лукавинка - доля лукавства {доля}
лукоморье - залива бухты {залива}
луч - полоса света {полоса}
лучепреломление - Изменение направления {Изменение}
лыжи - полозья спорта {полозья}
львенок - Детеныш льва {Детеныш}
львица - Самка льва {Самка}
лье - мера длины {мера}
льяло - отливки металла {отливки}
любительство - Занятие чем {Занятие}
любительщина - исполнение чего {исполнение}
любовь - Чувство расположения {Чувство}
люд - Множество толпы {Множество}
люди - буквы «л {буквы}
люкс - Единица измерения {Единица}
люмен - Единица измерения {Единица}
люминесценция - Свечение газа {Свечение}
люмпен-пролетариат - слой людей {слой}
люпус - туберкулеза кожи {туберкулеза}
лютеранство - направлений протестантизма {направлений}
лямблия - организм класса {организм}
магистр - степень главы {степень}
магистраль - линия какого {линия}
магистратура - Совокупность чинов {Совокупность}
магия - Совокупность приемов {Совокупность}
магма - зонах Земли {зонах}
магнезия - окиси магния {окиси}
магнетизм - Свойство магнита {Свойство}
магнитограмма - запись изменения {запись}
магометанин - Последователь магометанства {Последователь}
маевка - собрание рабочих {собрание}
мазок - Наложение краски {Наложение}
мазь - смесь жиров {смесь}
майолика - глина глаза {глина}
майорат - порядок наследования {порядок}
майорша - Жена майора {Жена}
макар - Макар телят {Макар}
макаронина - трубочка макарон {трубочка}
маклачество - Занятие маклака {Занятие}
маклерство - Занятие маклера {Занятие}
макроцефалия - величина головы {величина}
максимализм - Доведение каких {Доведение}
максималист - Сторонник максимализма {Сторонник}
макулатура - срок изделия {срок}
малинник - Заросли малины {Заросли}
маловерие - Недостаток веры {Недостаток}
маловодье - Недостаток воды {Недостаток}
малодушие - Отсутствие стойкости {Отсутствие}
малолесье - количество лесов {количество}
малолюдье - количество людей {количество}
малоснежье - количество снега {количество}
мальтузианец - Последователь мальтузианства {Последователь}
маневр - Передвижение вагонов {Передвижение}
манжета - обшлаг рукава {обшлаг}
манифестант - Участник манифестации {Участник}
мановение - Движение (руки {Движение}
мануфактурист - Владелец мануфактуры {Владелец}
маньячество - увлечение какой {увлечение}
мара - Призрак наваждение {Призрак}
мараловодство - Разведение маралов {Разведение}
марка - единица Финляндии {единица}
марка - Знак оплаты {Знак}
марксизм - Учение К {Учение}
марксизм-ленинизм - Учение Маркса {Учение}
марксист - Последователь марксизма {Последователь}
марсиане - обитателей Марса {обитателей}
мартиролог - сборник повествований {сборник}
маршал - звание какой {звание}
маршрут - путь следования {путь}
масленица - праздник проводов {праздник}
маслоделие - Процесс переработки {Процесс}
маслянистость - Степень содержания {Степень}
масон - Последователь масонства {Последователь}
мастак - деле человек {деле}
масть - Цвет шерсти {Цвет}
масштаб - Отношение отрезка {Отношение}
мат - Отсутствие блеска {Отсутствие}
материализм - идеализмом направлений {идеализмом}
материк - пространство суши {пространство}
материнство - Состояние женщины {Состояние}
матрица - обработке металла {обработке}
матроска - Жена матроса {Жена}
махинация - способ достижения {способ}
махист - Последователь махизма {Последователь}
махры - Бахрома кисти {Бахрома}
мачеха - Жена отца {Жена}
мгла - Пелена тумана {Пелена}
мгновение - промежуток времени {промежуток}
мегрелы - группа грузин {группа}
медаль - Знак отличия {Знак}
медведица - Самка медведя {Самка}
медведка - Насекомое отряда {Насекомое}
медвежатина - Мясо медведя {Мясо}
медвежонок - Детеныш медведя {Детеныш}
медиана - вершины треугольника {вершины}
медикаменты - средства лекарства {средства}
медоварение - Изготовление меда {Изготовление}
медуза - животное типа {животное}
междоузлие - Участок стебля {Участок}
межень - уровень лета {уровень}
межплодник - слой стенки {слой}
мезга - оболочка дерева {оболочка}
мелиорация - Система мероприятий {Система}
мелководье - уровень воды {уровень}
мелкота - величина чего {величина}
мелодия - последовательность звуков {последовательность}
мелок - Кусок мела {Кусок}
меломан - любитель музыки {любитель}
мельник - Владелец мельницы {Владелец}
мельхиор - Сплав меди {Сплав}
мемуарист - Автор мемуаров {Автор}
мемуары - Записи людей {Записи}
менингит - Воспаление оболочек {Воспаление}
мениск - поверхность жидкости {поверхность}
меньшевик - Последователь меньшевизма {Последователь}
меню - Подбор кушаний {Подбор}
мера - Единица измерения {Единица}
мерзавчик - бутылка водки {бутылка}
мерзлота - состояние почвы {состояние}
меринос - Порода овец {Порода}
мерка - Совокупность данных {Совокупность}
меркантилист - Последователь меркантилизма {Последователь}
мертвец - Мертвый человек {Мертвый}
мертвечина - Трупы животных {Трупы}
месиво - смесь муки {смесь}
местничество - порядок замещения {порядок}
местоположение - положение какого {положение}
месторождение - Место нахождения {Место}
месть - причинение зла {причинение}
месяц - Единица исчисления {Единица}
металлист - Рабочий металлопромышленности {Рабочий}
металлоемкость - Количество металла {Количество}
метаморфизм - Процесс изменения {Процесс}
метастаз - очаг болезни {очаг}
метафизика - Метод познания {Метод}
метафора - Употребление слова {Употребление}
метеослужба - Система наблюдений {Система}
метод - Способ познания {Способ}
методика - Совокупность методов {Совокупность}
методология - Совокупность приемов {Совокупность}
метонимия - Замена названия {Замена}
метр - Мера длины {Мера}
метраж - Длина чего {Длина}
метровка - метр длины {метр}
механизация - Оснащение производства {Оснащение}
механизм - Совокупность состояний {Совокупность}
механист - Последователь механицизма {Последователь}
механотерапия - Метод лечения {Метод}
меценатство - Деятельность мецената {Деятельность}
меч-рыба - рыба отряда {рыба}
мешанина - Смесь чего {Смесь}
миг - промежуток времени {промежуток}
миграция - Перемещение населения {Перемещение}
мизансцена - Расположение актеров {Расположение}
мизинец - палец руки {палец}
микология - Раздел ботаники {Раздел}
микориза - сожительство мицелия {сожительство}
микроминиатюризация - уменьшение размеров {уменьшение}
микрорельеф - Рельеф местности {Рельеф}
микроскопия - методов наблюдения {методов}
микрофлора - Совокупность микроорганизмов {Совокупность}
микроцефалия - размеры черепа {размеры}
микроэлектроника - Область электроники {Область}
милитаризм - политика усиления {политика}
милиционер - Работник милиции {Работник}
миллиардер - Обладатель богатства {Обладатель}
миллиграмм - доля грамма {доля}
миллиметр - доля метра {доля}
миллионер - Обладатель богатства {Обладатель}
милок - мужчины (мальчика {мужчины}
милорд - Наименование аристократа {Наименование}
миля - мера длины {мера}
миляга - себе человек {себе}
мимика - Движение мышц {Движение}
мина - Выражение лица {Выражение}
минарет - Башня мечети {Башня}
миндаль - дерево орехов {дерево}
миниатюризация - Уменьшение размеров {Уменьшение}
минимализм - снижение требований {снижение}
минималист - Сторонник минимализма {Сторонник}
министерша - Жена министра {Жена}
министр - Член правительства {Член}
минование - миновании надобности {миновании}
минута - Единица измерения {Единица}
миокард - слой сердца {слой}
миокардит - Заболевание миокарда {Заболевание}
мирза - Титул членов {Титул}
мировоззрение - Совокупность принципов {Совокупность}
мироедство - Образ действий {Образ}
мирок - круг людей {круг}
миропонимание - Совокупность взглядов {Совокупность}
миросозерцание - Совокупность взглядов {Совокупность}
миротворство - Действия миротворца {Действия}
миссионерство - Деятельность миссионера {Деятельность}
мистер - Наименование мужчины {Наименование}
мистификация - введение кого {введение}
мифотворчество - Создание мифов {Создание}
мичман - звание лиц {звание}
младенчество - детство неразвитости {детство}
мнемоника - Совокупность правил {Совокупность}
многоводье - Избыток воды {Избыток}
многоголосие - Склад музыки {Склад}
многолюдство - скопление людей {скопление}
многоножки - группы животных {группы}
многообразие - Проявление чего {Проявление}
многословие - Излишество слов {Излишество}
многотиражка - газета предприятия {газета}
многоточие - Знак препинания {Знак}
мобилизация - Призыв военнообязанных {Призыв}
модель - экземпляр какого {экземпляр}
модернист - Последователь модернизма {Последователь}
модификация - Видоизменение предмета {Видоизменение}
модуль - области коэффициентов {области}
мозоль - Утолщение кожи {Утолщение}
мокша - группа мордвы {группа}
молекула - частица вещества {частица}
молодняк - животные птицы {животные}
молодь - свет растения {свет}
молоки - жидкость рыб {жидкость}
молокопоставки - сдача молока {сдача}
молчок - Молчание слова {Молчание}
моль - единица количества {единица}
момент - промежуток времени {промежуток}
монарх - глава государства {глава}
монархист - Сторонник монархизма {Сторонник}
монастырь - община монахов {община}
монголоведение - Совокупность дисциплин {Совокупность}
монетница - Коробка род {Коробка}
монист - Последователь монизма {Последователь}
монополия - право пользования {право}
монотеист - Последователь монотеизма {Последователь}
мораль - Совокупность принципов {Совокупность}
мораторий - Отсрочка платежей {Отсрочка}
морена - Скопление обломков {Скопление}
моржиха - Самка моржа {Самка}
моржонок - Детеныш моржа {Детеныш}
морозилка - Камера холодильника {Камера}
москатель - вещества (краски {вещества}
мостостроение - Постройка мостов {Постройка}
мосье","мсье - Наименование мужчины {Наименование}
мотив - элемент темы {элемент}
мотовство - трата денег {трата}
моторостроение - Отрасль промышленности {Отрасль}
мотыль - Личинка комара {Личинка}
мохер - шерсть козы {шерсть}
мочалка - Пучок мочал {Пучок}
мочевыделение - выведение мочи {выведение}
мочеотделение - Процесс образования {Процесс}
мочеточник - проток почки {проток}
мощи - останки людей {останки}
мрак - отсутствие света {отсутствие}
мракобес - враг прогресса {враг}
му'ка - страдание чем {страдание}
мужество - Присутствие духа {Присутствие}
муза - богинь покровительниц {богинь}
мука' - продукт питания {продукт}
мулица - Самка мула {Самка}
мумия - труп человека {труп}
мурлыка - кота кошки {кота}
мурлыканье - урчание (кошки {урчание}
мускулатура - Совокупность мускулов {Совокупность}
мусульманин - Последователь мусульманства {Последователь}
мутант - Особь животных {Особь}
мутация - изменение чего {изменение}
мутовка - Группа ветвей {Группа}
мученичество - Состояние мученика {Состояние}
мучительство - Причинение мук {Причинение}
муштра - Метод воспитания {Метод}
мы - обозначения группы {обозначения}
мызник - Владелец мызы {Владелец}
мыловарение - Производство мыла {Производство}
мыслете - буквы «м {буквы}
мысль - процесс мышления {процесс}
мыт - болезнь лошадей {болезнь}
мытарство - Мучение страдание {Мучение}
мытарь - сборщика податей {сборщика}
мычание - крик коров {крик}
мышление - Способность человека {Способность}
мышонок - Детеныш мыши {Детеныш}
мэр - Глава муниципалитета {Глава}
мясник - Продавец мяса {Продавец}
мясозаготовки - заготовки мяса {заготовки}
мясопоставки - сдача мяса {сдача}
мятежник - Участник мятежа {Участник}
мяуканье - Крик кошки {Крик}
на'волочь - Облака тучи {Облака}
набат - Сигнал тревоги {Сигнал}
наборщик - Рабочий типографии {Рабочий}
навалоотбойка - Отбойка угля {Отбойка}
наводнение - затопление местности {затопление}
навоз - смесь помета {смесь}
нагар - кончик фитиля {кончик}
наглеца - долей наглости {долей}
наговор - Клевета напраслина {Клевета}
надворье - участок земли {участок}
наддув - Усиление подачи {Усиление}
надежда - Ожидание чего {Ожидание}
надир - Точка пересечения {Точка}
надкрылья - крылья жуков {крылья}
надобность - Необходимость потребность {Необходимость}
надомник - Рабочий предприятия {Рабочий}
надсада - напряжение сил {напряжение}
наездничество - Занятие наездника {Занятие}
назализация - Произношение звуков {Произношение}
название - обозначение какого {обозначение}
назначаемость - Замещение должностей {Замещение}
наказание - Мера воздействия {Мера}
накатник - Доски бревна {Доски}
накожник - чесоточного клеща {чесоточного}
накрытие - Поражение цели {Поражение}
намагниченность - Состояние тела {Состояние}
наместник - Заместитель кого {Заместитель}
наместница - Помощница настоятельницы {Помощница}
нападки - Обвинения придирки {Обвинения}
наркоз - обезболивание какого {обезболивание}
наркология - Раздел медицины {Раздел}
народник - Последователь народничества {Последователь}
народность - общность людей {общность}
народонаселение - Население страны {Население}
нарост - Слой какого {Слой}
наружность - облик кого {облик}
нарыв - воспаление какой {воспаление}
населенность - Степень заселения {Степень}
наслаждение - степень удовольствия {степень}
наследие - явление культуры {явление}
наслышка - кто чем {кто}
наставничество - Положение обязанности {Положение}
наступление - Движение войск {Движение}
натр - окиси натрия {окиси}
натуга - Напряжение сил {Напряжение}
натурализация - Принятие иностранцев {Принятие}
натуроплата - Оплата чего {Оплата}
натурфилософ - Последователь натурфилософии {Последователь}
наука - Система знаний {Система}
наущение - наущению Толстого {наущению}
наценка - Повышение цены {Повышение}
националист - Приверженец национализма {Приверженец}
нацист - Приверженец нацизма {Приверженец}
начало - точка грани {точка}
начин - Начало чего {Начало}
наш - буквы «н {буквы}
нашествие - Вторжение неприятеля {Вторжение}
наяда - нимфа рек {нимфа}
неблагоустроенность - Отсутствие условий {Отсутствие}
небожитель - Обитатель неба {Обитатель}
небытие - Отсутствие существования {Отсутствие}
невежда - человек неуч {человек}
невежество - Отсутствие знаний {Отсутствие}
невезение - стечение обстоятельств {стечение}
неверие - Отсутствие веры {Отсутствие}
невзнос - Неуплата денег {Неуплата}
невинность - Отсутствие вины {Отсутствие}
неволя - Отсутствие свободы {Отсутствие}
неврит - Воспаление нерва {Воспаление}
неврология - Совокупность наук {Совокупность}
невыгода - Отсутствие выгоды {Отсутствие}
невыполнение - Неосуществление чего {Неосуществление}
невязка - Несхождение линий {Несхождение}
негативизм - сопротивление чему {сопротивление}
негус - титул императора {титул}
неделя - Единица исчисления {Единица}
недержание - Недержание мочи {Недержание}
недоверие - Отсутствие доверия {Отсутствие}
недовольство - Чувство неудовлетворения {Чувство}
недоговоренность - Отсутствие договоренности {Отсутствие}
недожин - количество чего {количество}
недолет - Падение снаряда {Падение}
недомыслие - обдуманность чего {обдуманность}
недопроизводство - производство чего {производство}
недоразвитие - развитие кого {развитие}
недоразумение - понимание чего {понимание}
недостаток - Отсутствие средств {Отсутствие}
недостача - Отсутствие какого {Отсутствие}
недочет - Недостаток чего {Недостаток}
нежвачные - подотряда млекопитающих {подотряда}
нежелание - Отсутствие желания {Отсутствие}
незадача - стечение обстоятельств {стечение}
незлобие - Отсутствие злобы {Отсутствие}
незнакомство - Отсутствие знаний {Отсутствие}
незнание - Отсутствие знаний {Отсутствие}
неимение - неимением места {неимением}
неистовство - проявление какого {проявление}
нейропсихология - Раздел психологии {Раздел}
нейрохирургия - Раздел хирургии {Раздел}
нейтралитет - политика неучастия {политика}
некомплект - Отсутствие комплекта {Отсутствие}
нектар - напиток богов {напиток}
нелады - Недоразумения ссоры {Недоразумения}
нелюбовь - Чувство нерасположения {Чувство}
немилость - Отсутствие расположения {Отсутствие}
немота - Отсутствие дара {Отсутствие}
ненадобность - Отсутствие надобности {Отсутствие}
неодобрение - Неудовлетворенность чьими {Неудовлетворенность}
неосуществимость - Невозможность осуществления {Невозможность}
неофит - приверженец какой {приверженец}
непокой - Отсутствие покоя {Отсутствие}
неполадки - Отсутствие налаженности {Отсутствие}
неполногласие - языка сочетания {языка}
неполноправие - Отсутствие полноправия {Отсутствие}
непонимание - Отсутствие понимания {Отсутствие}
непосещение - Непоявление где {Непоявление}
непотопляемость - Способность судна {Способность}
неправоспособность - Неспособность (гражданина {Неспособность}
непривычка - Отсутствие привычки {Отсутствие}
непричастность - Отсутствие причастности {Отсутствие}
неравенство - Отсутствие равенства {Отсутствие}
неравнодушие - Проявление интереса {Проявление}
неравноправие - Отсутствие равноправия {Отсутствие}
неразбериха - Отсутствие порядка {Отсутствие}
нерасположение - Отсутствие расположения {Отсутствие}
нервация - Характер распределения {Характер}
нервотрепка - Обстоятельства условия {Обстоятельства}
нерестилище - Место нереста {Место}
нерка - Рыба рода {Рыба}
несварение - Несварение желудка# {Несварение}
несвобода - Отсутствие свободы {Отсутствие}
несение - Выполнение каких {Выполнение}
нескладица - толку смысла {толку}
несовершеннолетие - Возраст человека {Возраст}
несовершенство - Неполнота каких {Неполнота}
несогласие - Отсутствие согласия {Отсутствие}
несоответствие - Отсутствие соответствия {Отсутствие}
неспособность - Отсутствие способности {Отсутствие}
несходство - Отсутствие сходства {Отсутствие}
неуважение - Отсутствие уважения {Отсутствие}
неудача - исход какого {исход}
неудобь - посевов лугов {посевов}
неудовольствие - Чувство недовольства {Чувство}
неумение - Недостаток умения {Недостаток}
неуплата - Невнесение платы {Невнесение}
неуправка - Неисправность неполадки {Неисправность}
неурожай - урожай недород {урожай}
неустройство - Отсутствие порядка {Отсутствие}
неуют - Отсутствие уюта {Отсутствие}
нефрит - Воспаление почек {Воспаление}
нефтепровод - Система труб {Система}
неявка - Отсутствие кого {Отсутствие}
неясыть - Птица отряда {Птица}
нигерийцы - Население Нигерии {Население}
нирвана - состояние покоя {состояние}
нихром - Сплав никеля {Сплав}
нищенство - Собирание милостыни {Собирание}
новаторство - Деятельность новатора {Деятельность}
новолуние - Фаза Луны {Фаза}
нога - конечностей птиц {конечностей}
ноздря - отверстий носа {отверстий}
номенклатура - Перечень названий {Перечень}
номер - число размера {число}
номография - Раздел математики {Раздел}
норматив - Показатель норм {Показатель}
нос - Орган обоняния {Орган}
носкость - Способность (птиц {Способность}
носкость - Степень прочности {Степень}
носорог - млекопитающее отряда {млекопитающее}
нота - обращение правительства {обращение}
нота - знак какого {знак}
нотариат - Система органов {Система}
ночевка - Остановка где {Остановка}
ночница - бабочка совка {бабочка}
нравственность - Совокупность норм {Совокупность}
нужда - Отсутствие средств {Отсутствие}
нуждаемость - Степень нужды {Степень}
нунций - представитель папы {представитель}
нутрия - Животное отряда {Животное}
нэп - политика (см {политика}
нёбо - стенка полости {стенка}
о'круг - частей государства {частей}
обвалка - Отделение мяса {Отделение}
обдирка - обработка заготовок {обработка}
обед - принятие пищи {принятие}
обезличка - распорядок работы {распорядок}
обезуглероживание - Уменьшение содержания {Уменьшение}
обезьянничество - подражание кому {подражание}
обер-офицер - чин капитана {чин}
обеспеченность - Степень обеспечения {Степень}
обессеривание - Удаление серы {Удаление}
обзорность - Величина пространства {Величина}
обилие - количество кого {количество}
обитель - Монастырь пребывания {Монастырь}
облачность - Степень покрытия {Степень}
облик - наружность кого {наружность}
облиственность - Степень покрытия {Степень}
облитерация - Уничтожение полости {Уничтожение}
обложка - покрышка книги {покрышка}
обломок - кусок чего {кусок}
облоно - Сокращение слов {Сокращение}
облысение - Выпадение волос {Выпадение}
обманка - составе названий {составе}
обморок - потеря сознания {потеря}
обоз - подвод повозок {подвод}
обои - полосы бумаги {полосы}
обойки - Остатки льна {Остатки}
оборка - Полоса материи {Полоса}
оборонец - Сторонник оборончества {Сторонник}
оборончество - Политика защиты {Политика}
оборотность - Количество оборотов {Количество}
оборы - Веревки завязки {Веревки}
обрабатываемость - Способность материала {Способность}
образование - Процесс усвоения {Процесс}
обрывок - кусок чего {кусок}
обрядность - Система обрядов {Система}
обскурант - Сторонник обскурантизма {Сторонник}
обстановка - Совокупность условий {Совокупность}
обструкция - срыв чего {срыв}
обтюрация - Устранение прорыва {Устранение}
обуглероживание - введение углерода {введение}
обусловленность - Необходимость чего {Необходимость}
обхождение - Манера поведения {Манера}
общество - Совокупность людей {Совокупность}
обществовед - Преподаватель обществоведения {Преподаватель}
община - объединения людей {объединения}
объедья - Остатки сена {Остатки}
объективист - Последователь объективизма {Последователь}
объем - Величина чего {Величина}
обыватель - житель какой {житель}
обыск - осмотр кого {осмотр}
обязанность - круг действий {круг}
овация - Выражение одобрения {Выражение}
овод - насекомое личинки {насекомое}
овсянка - птица отряда {птица}
овцеводство - Отрасль животноводства {Отрасль}
оглавление - Перечень глав {Перечень}
огласка - Предание известности {Предание}
огнепоклонничество - Культ огня {Культ}
огниво - Кусок камня {Кусок}
огород - Участок земли {Участок}
огрызок - кусок чего {кусок}
одежда - Совокупность предметов {Совокупность}
однообразие - Отсутствие перемен {Отсутствие}
одночасье - промежуток времени {промежуток}
одонтология - раздела стоматологии {раздела}
одописец - Автор од {Автор}
одурь - Помрачение сознания {Помрачение}
ожог - Повреждение ткани {Повреждение}
озноб - Ощущение холода {Ощущение}
окалина - Продукт окисления {Продукт}
океан - пространство Земли {пространство}
океанология - Совокупность наук {Совокупность}
окись - степень окисления {степень}
окклюзия - Поглощение газов {Поглощение}
окклюзия - Соотношение зубов {Соотношение}
оклик - Возглас слова {Возглас}
околоплодник - Стенка плода {Стенка}
оленеводство - Отрасль животноводства {Отрасль}
олененок - Детеныш оленя {Детеныш}
оленина - Мясо оленя {Мясо}
оленуха - Самка оленя {Самка}
олеография - способ воспроизведения {способ}
олимпиада - Промежуток времени {Промежуток}
ольшаник - лес заросли {лес}
оляпка - птица отряда {птица}
ом - Единица измерения {Единица}
омоложение - Возвращение признаков {Возвращение}
омонимика - Совокупность омонимов {Совокупность}
омонимия - совпадение слов {совпадение}
омыление - Реакция разложения {Реакция}
он - предмет речи {предмет}
она - предмет речи {предмет}
онеры - онерами ничего {онерами}
они - предмет речи {предмет}
оно - предмет речи {предмет}
опасение - Предчувствие опасности {Предчувствие}
оперение - покров птицы {покров}
опивки - остатки чего {остатки}
опилки - частицы материала {частицы}
опой - воспаление копыт {воспаление}
опора - что сооружения {что}
оппортунист - Сторонник оппортунизма {Сторонник}
опрелость - Раздражение кожи {Раздражение}
опробковение - Изменение оболочек {Изменение}
оптация - Выбор гражданства {Выбор}
оптика - Раздел физики {Раздел}
опушка - Край леса {Край}
опыление - Перенос пыльцы {Перенос}
опылитель - Переносчик пыльцы {Переносчик}
опыт - Совокупность знаний {Совокупность}
опытничество - Проведение опытов {Проведение}
орбита - Путь движения {Путь}
ордалия - способ определения {способ}
ординатор - врач больницы {врач}
ординатура - аспирантуры ординатора {аспирантуры}
ореол - круг головы {круг}
оригинал - предметом перевода {предметом}
ориентализм - Изучение Востока {Изучение}
ориенталистика - Совокупность наук {Совокупность}
орленок - Птенец орла {Птенец}
орлица - Самка орла {Самка}
орнитология - Раздел зоологии {Раздел}
орография - Раздел геоморфологии {Раздел}
ортодоксия - следование какому {следование}
ортопедия - Раздел медицины {Раздел}
орфография - система правил {система}
орфоэпия - Система правил {Система}
осадок - частицы какого {частицы}
осведомленность - Наличие каких {Наличие}
осень - Время года {Время}
осетрина - Мясо осетра {Мясо}
осечка - Отсутствие выстрела {Отсутствие}
осина - дерево рода {дерево}
оскребки - Остатки чего {Остатки}
осленок - Детеныш осла {Детеныш}
ослица - Самка осла {Самка}
ослышка - Ошибка слуха {Ошибка}
оснащенность - Степень оснащения {Степень}
основоположник - Создатель какого {Создатель}
осокорник - Заросли осокоря {Заросли}
осолаживание - Способ увеличения {Способ}
останки - Тело покойника {Тело}
остеология - Раздел анатомии {Раздел}
остойчивость - Способность судна {Способность}
острие - конец чего {конец}
островитянин - Житель острова {Житель}
остроумие - Изощренность мысли {Изощренность}
остряк - остроты человек {остроты}
осуждение - Признание виновности {Признание}
осуществимость - Возможность осуществления {Возможность}
осциллятор - Система тел {Система}
отара - Стадо овец {Стадо}
отбойка - Отделение кусков {Отделение}
отбросы - остатки чего {остатки}
отворот - край одежды {край}
отвычка - Утрата какой {Утрата}
отзвук - Отражение звука {Отражение}
отзовист - Сторонник отзовизма {Сторонник}
откос - поверхность горы {поверхность}
откуп - Право взимания {Право}
отношение - характер поведения {характер}
оторванность - Отсутствие связи {Отсутствие}
оторочка - полоска ткани {полоска}
отплытие - Отход (судна {Отход}
отпор - Отражение нападения {Отражение}
отпущение - Прощение (грехов {Прощение}
отрада - Чувство удовольствия {Чувство}
отрасль - побег растения {побег}
отрезанность - Отсутствие возможности {Отсутствие}
отрезок - кусок чего {кусок}
отрешенность - Состояние человека {Состояние}
отроек - рой пчел {рой}
отросток - побег растения {побег}
отрыжка - Вывод газов {Вывод}
отряд - группа людей {группа}
отсвет - свет чего {свет}
отсидка - Отбывание наказания {Отбывание}
отсутствие - Ненахождение какого {Ненахождение}
оттиск - Отпечаток текста {Отпечаток}
отточие - Ряд точек {Ряд}
отходничество - уход крестьян {уход}
отходы - Остатки какого {Остатки}
отчаяние - Состояние безнадежности {Состояние}
отчетность - Проведение отчета {Проведение}
отчизна - Отечество родина {Отечество}
отчим - Муж матери {Муж}
отчужденность - Отсутствие близости {Отсутствие}
отъем - Отделение детеныша {Отделение}
официант - Работник столовой {Работник}
офсет - Способ печатания {Способ}
охапка - количество чего {количество}
охота - Желание чего {Желание}
очарование - сила кого {сила}
очередь - порядок очередности {порядок}
очерет - растение род {растение}
пава - Самка павлина {Самка}
паводок - поднятие уровня {поднятие}
пагинация - Нумерация страниц {Нумерация}
падаль - Труп животного {Труп}
паде'ж - изменения имени {изменения}
падишах - Титул монарха {Титул}
падёж - гибель (скота {гибель}
пакет - обертку какой {обертку}
пакистанцы - Население Пакистана {Население}
палатальность - Наличие смягчения {Наличие}
палеоантропология - Раздел антропологии {Раздел}
палестинцы - Население Палестины {Население}
палетка - Сетка квадратов {Сетка}
палец - частей механизма {частей}
палинология - Раздел ботаники {Раздел}
палисадина - Жердь палисадника {Жердь}
палисадник - забор изгородь {забор}
палтус - рыба отряда {рыба}
пальпация - Метод исследования {Метод}
памфлетист - Автор памфлетов {Автор}
пан - Польше Чехословакии {Польше}
панама - шляпы ткани {шляпы}
панариций - воспаление тканей {воспаление}
панбархат - ткань род {ткань}
пандекты - Сборники извлечений {Сборники}
панна - дочь пана {дочь}
пансионер - Учащийся пансиона {Учащийся}
панство - Паны (см {Паны}
пантеист - Последователь пантеизма {Последователь}
пантовка - Срезывание пантов {Срезывание}
пантомимика - Совокупность движений {Совокупность}
папильотки - Кусочки бумаги {Кусочки}
папороток","папоротка - сустав крыла {сустав}
пар - Поле севооборота {Поле}
парабола - Линия пересечения {Линия}
парагвайцы - население Парагвая {население}
парад - прохождение войск {прохождение}
парадигма - Система форм {Система}
паразитство - образ жизни {образ}
параллакс - смещение светила {смещение}
парапсихология - Область исследований {Область}
паритет - Принцип равенства {Принцип}
паркетина - дощечка паркета {дощечка}
парламентарий - Член парламента {Член}
парламентерство - Обязанности функции {Обязанности}
пароксизм - обострение какой {обострение}
пароходство - Совокупность учреждений {Совокупность}
пароходчик - Владелец пароходов {Владелец}
парсек - Единица измерения {Единица}
партбилет - билет члена {билет}
партвзносы - взносы Членов {взносы}
партгрупорг - Руководитель партгруппы {Руководитель}
партизанство - борьба действия {борьба}
партитура - запись всех {запись}
партия - организация какого {организация}
парткомовец - Член парткома {Член}
партсобрание - собрание членов {собрание}
парусность - площадь парусов {площадь}
парцелляция - Разбивка земли {Разбивка}
пас - Передача мяча {Передача}
пасечник - Работник пасеки {Работник}
паскаль - Единица давления {Единица}
пасквилянт - Автор пасквиля {Автор}
паспарту - Лист картона {Лист}
паспортизация - Введение системы {Введение}
пассаты - протяжении года {протяжении}
пассив - Совокупность долгов {Совокупность}
пассия - Предмет любви {Предмет}
пассы - движения рук {движения}
пастель - порошок красок {порошок}
пасторство - Деятельность пастора {Деятельность}
пастушество - Занятие пастуха {Занятие}
пастырство - Деятельность пастыря {Деятельность}
пасть - Рот зверя {Рот}
патлы - пряди волос {пряди}
патогенез - Последовательность возникновения {Последовательность}
патриархальщина - Пережитки старины {Пережитки}
патронесса - покровительница какого {покровительница}
пацифист - Сторонник пацифизма {Сторонник}
педантство - Поведение свойства {Поведение}
пейсы - пряди волос {пряди}
пени - Сетования жалобы {Сетования}
пенкоснимательство - Образ действий {Образ}
пеночка - птичка отряда {птичка}
пентаметр - Размер стиха {Размер}
пепелище - Место пожара {Место}
пепельница - Тарелочка какой {Тарелочка}
первозимье - Начало зимы {Начало}
первоисточник - начало чему {начало}
первопричина - причина чего {причина}
пергидроль - раствор перекиси {раствор}
переаренда - Аренда имущества {Аренда}
перебой - Неравномерность ритма {Неравномерность}
переизбыток - избыток чего {избыток}
перекись - степень окисления {степень}
перекресток - Место пересечения {Место}
перекрестье - линий планок {линий}
перелесок - лес участков {лес}
перелог - участок земли {участок}
перемирие - прекращение ссоры {прекращение}
перенаселение - Избыток населения {Избыток}
переносимость - Способность организма {Способность}
перепад - Падение воды {Падение}
перепелка - Самка перепела {Самка}
перепись - учет кого {учет}
переплеск - плеск чего {плеск}
пересекаемость - Наличие пересечения {Наличие}
пересмена","пересменка - Промежуток времени {Промежуток}
пересмех - Смех насмешки {Смех}
пересмешки - Смешки издевки {Смешки}
пересортица - Перевод товаров {Перевод}
перестановка - Изменение порядка {Изменение}
перечень - Перечисление кого {Перечисление}
перешеек - Полоса суши {Полоса}
перикард - оболочка сердца {оболочка}
перикардит - Воспаление перикарда {Воспаление}
периметр - Сумма длины {Сумма}
период - Промежуток времени {Промежуток}
периостит - Воспаление надкостницы {Воспаление}
перипетии - события обстоятельства {события}
перистальтика - сокращения стенок {сокращения}
перитонит - Воспаление брюшины {Воспаление}
перицентр - Точка орбиты {Точка}
персонал - состав какого {состав}
перст - Палец руки {Палец}
перфект - время глаголов {время}
перцепция - отражение действительности {отражение}
першерон - Порода лошадей {Порода}
песенник - Исполнитель песен {Исполнитель}
песета - единица Испании {единица}
пескоройка - Личинка миноги {Личинка}
песня - произведение птиц {произведение}
песо - единица ряда {единица}
песчинка - Крупинка песка {Крупинка}
петрография - Раздел геологии {Раздел}
петух - Самец курицы {Самец}
пехотинец - Боец пехоты {Боец}
печаль - Чувство грусти {Чувство}
печенеги - Союз племен {Союз}
печень - железа человека {железа}
пи - Отношение длины {Отношение}
пианизм - Искусство игры {Искусство}
пиастр - единица Турции {единица}
пивоварение - Изготовление пива {Изготовление}
пигментация - Окраска тканей {Окраска}
пиетизм - протестантов Германии {протестантов}
пиетист - Сторонник пиетизма {Сторонник}
пижонство - Поведение пижона {Поведение}
пикадор - Участник боя {Участник}
пикет - отряд бастующих {отряд}
пикет - Точка местности {Точка}
пикетаж - Выбор точек {Выбор}
пилотаж - Искусство управления {Искусство}
пимокат - валяльщик пимов {валяльщик}
пимы - сапоги Сибири {сапоги}
пинакотека - Хранилище произведений {Хранилище}
пинта - Единица измерения {Единица}
пионерия - Пионеры (см {Пионеры}
пипка - трубка шланга {трубка}
пиратство - Занятие пирата {Занятие}
пиротехника - Отрасль техники {Отрасль}
писарство - Занятие писаря {Занятие}
писательство - Занятие писателя {Занятие}
письмена - знаки буквы {знаки}
письмовник - Сборник образцов {Сборник}
письмоводитель - Служащий канцелярии {Служащий}
пищуха - птица отряда {птица}
плав - состоянии плавания {состоянии}
плавник - Обломки деревьев {Обломки}
плавник - Орган передвижения {Орган}
плагиаторство - Занятие плагиатора {Занятие}
планеризм - Искусство летания {Искусство}
планетология - Комплекс наук {Комплекс}
плантаж - перекапывание почвы {перекапывание}
плантатор - Владелец плантации {Владелец}
плантаторство - Занятие плантатора {Занятие}
пласт - слой чего {слой}
пластика - Искусство создания {Искусство}
пластина - полоса какого {полоса}
платинит - Сплав железа {Сплав}
платок - Кусок ткани {Кусок}
плаха - Кусок бревна {Кусок}
плашка - кусок дерева {кусок}
плебейство - Плебеи (в {Плебеи}
плевок - сгусток слюны {сгусток}
плеврит - Воспаление плевры {Воспаление}
племя - объединение людей {объединение}
племянник - Сын брата {Сын}
племянница - Дочь брата {Дочь}
плен - Положение кого {Положение}
плеоназм - Оборот речи {Оборот}
плес - Участок реки {Участок}
плешивость - Наличие плеши {Наличие}
плод - Орган растения {Орган}
плодоводство - Отрасль растениеводства {Отрасль}
плодородие - Способность (почвы {Способность}
плодосбор - Сбор плодов {Сбор}
плодосмен - система земледелия {система}
плоскостопие - недостаток ноги {недостаток}
плот - рядов бревна {рядов}
плотбище - Место заготовки {Место}
площадка - участок земли {участок}
плюралист - Последователь плюрализма {Последователь}
плюсование - Пропитывание (ткани {Пропитывание}
пневмония - Воспаление легких {Воспаление}
побег - стебель растения {стебель}
побежалость - окраска поверхности {окраска}
побережье - Полоса земли {Полоса}
побратимство - обычай закрепления {обычай}
поведение - Образ действий {Образ}
повертка","поверток - Поворот дороги {Поворот}
поверхность - сторона чего {сторона}
повойник - убор русских {убор}
повстанец - Участник восстания {Участник}
повстанчество - Борьба действия {Борьба}
повторяемость - Наличие повторений {Наличие}
повытчик - Служитель канцелярии {Служитель}
повязка - кусок ткани {кусок}
погода - Состояние атмосферы {Состояние}
поголовье - число голов {число}
погоны - знаки различия {знаки}
погоня - Преследование кого {Преследование}
пограничник - Военнослужащий войск {Военнослужащий}
погрыз - Следы зубов {Следы}
подагра - Болезнь суставов {Болезнь}
подачка - Кусок еды {Кусок}
подведомственность - Отнесение дел {Отнесение}
подвид - подразделений вида {подразделений}
подвижничество - Образ жизни {Образ}
подгорье - склон горы {склон}
подготовленность - Наличие запаса {Наличие}
подгруппа - Подразделение группы {Подразделение}
подданство - Принадлежность лица {Принадлежность}
поддев - ловли рыбы {ловли}
поддевка - одежда род {одежда}
поддон - дно чего {дно}
поденка - насекомое продолжительность {насекомое}
поджог - учинение пожара {учинение}
подкласс - Подразделение класса {Подразделение}
подколенки - сторона колен {сторона}
подкомиссия - Группа лиц {Группа}
подкомитет - Группа лиц {Группа}
подкрылье - сторона крыла {сторона}
подлежащее - член предложения {член}
подлекарь - Помощник лекаря {Помощник}
подлисок - лисица лисицы {лисица}
подлокотник - Ручка кресла {Ручка}
подмастерье - Подручный мастера {Подручный}
подмышник - Кусок ткани {Кусок}
подноготная - обстоятельства подробности {обстоятельства}
подол - край какого {край}
подонки - Остатки жидкости {Остатки}
подоснова - основа чего {основа}
подотряд - Подразделение отряда {Подразделение}
подпасок - Помощник пастуха {Помощник}
подпитие - состоянии опьянения {состоянии}
подплетина - нить основы {нить}
подражательство - Следование каким {Следование}
подрясник - одежда священнослужителей {одежда}
подсемейство - Подразделение семейства {Подразделение}
подстрочник - перевод какого {перевод}
подтекст - смысл какого {смысл}
подтекстовка - Сочинение текста {Сочинение}
подтоварник - бревна жерди {бревна}
подторжье - Канун ярмарки {Канун}
подхалимство - Поведение подхалима {Поведение}
подхорунжий - чин подпрапорщика {чин}
подчасок - Помощник часового {Помощник}
подшкипер - Помощник шкипера {Помощник}
подштурман - Помощник штурмана {Помощник}
подъесаул - чин штабс-капитана {чин}
поза - Положение тела {Положение}
позерство - Поведение позера {Поведение}
позитивист - Последователь позитивизма {Последователь}
позитрон - частица вещества {частица}
позиция - Положение тела {Положение}
позолота - слой золота {слой}
позыв - Ощущение какой {Ощущение}
показуха - знач действия {знач}
поклевка - клев рыбы {клев}
поклон - Наклонение головы {Наклонение}
покой - Отсутствие движения {Отсутствие}
покой - буквы «п {буквы}
покойник - Умерший человек {Умерший}
поколение - Совокупность людей {Совокупность}
покрик - крик (зверя {крик}
покромка - Полоска края {Полоска}
покрывало - Кусок ткани {Кусок}
пол - Совокупность признаков {Совокупность}
пол-литра - Половина литра {Половина}
пол-оборота - Половина оборота {Половина}
полбутылки - Половина бутылки {Половина}
полвека - Половина века {Половина}
полвзвода - Половина взвода {Половина}
полводы - Участок реки {Участок}
полгода - Половина года {Половина}
полдела - Половина дела {Половина}
полдень - Середина дня {Середина}
полдня - Половина дня {Половина}
полдороги - Половина дороги {Половина}
полдюжины - Половина дюжины {Половина}
полегаемость - Наличие полегания {Наличие}
полегание - Пригибание стеблей {Пригибание}
полено - кусок ствола {кусок}
полетность - Наличие полета {Наличие}
полетчик - Артист цирка {Артист}
полжизни - Половина жизни {Половина}
полиграфия - Отрасль техники {Отрасль}
полимеризация - Процесс получения {Процесс}
полимеры - Вещества молекулы {Вещества}
полиплоидия - увеличение числа {увеличение}
политеист - Последователь политеизма {Последователь}
политехнизм - Система обучения {Система}
политипаж - Отпечаток гравюры {Отпечаток}
политотделец - Работник политотдела {Работник}
политпросвет - учреждений органов {учреждений}
политучеба - Изучение марксизма {Изучение}
полихромия - Многоцветность произведений {Многоцветность}
полиция - орган милиции {орган}
полицмейстер","полицеймейстер - Начальник полиции {Начальник}
полковник - звание полка {звание}
полковница - Жена полковника {Жена}
полкольца - Половина кольца {Половина}
полкруга - Половина круга {Половина}
поллитровка - бутылка (водки {бутылка}
поллюция - истечение семени {истечение}
полмесяца - Половина месяца {Половина}
полмира - Половина мира {Половина}
полноводье - уровень воды {уровень}
полногласие - языков сочетания {языков}
полнокровие - Увеличение массы {Увеличение}
полнолуние - фаз Луны {фаз}
полночи - Половина ночи {Половина}
полночь - Середина ночи {Середина}
половина - целое частей {целое}
половодье - Разлив реки {Разлив}
полоз - частей саней {частей}
полоса - кусок чего {кусок}
полотнище - Кусок ткани {Кусок}
полпредство - представительство СССР {представительство}
полпути - Половина пути {Половина}
полроты - Половина роты {Половина}
полслова - Половина слова {Половина}
полсотни - Половина сотни {Половина}
полсуток - Половина суток {Половина}
полувзвод - Половина взвода {Половина}
полугодие - Промежуток времени {Промежуток}
полудуга - половины дуги {половины}
полудужье - половины дуги {половины}
полузащитник - Игрок полузащиты {Игрок}
полуимя - имя какого {имя}
полукольцо - половины кольца {половины}
полумасса - Масса волокна {Масса}
полумесяц - диск луны {диск}
полуобезьяны - Млекопитающие отряда {Млекопитающие}
полуоборот - Поворот туловища {Поворот}
полурота - Половина роты {Половина}
полусвет - среда женщин {среда}
полусмерть - До полусмерти# {До}
полусотня - Половина сотни {Половина}
полустолетие - Промежуток времени {Промежуток}
полуэскадрон - Половина эскадрона {Половина}
полчаса - Половина часа {Половина}
полшара - Половина шара {Половина}
полюс - Точка пересечения {Точка}
полярография - метод определения {метод}
поместье - владение помещика {владение}
помета - знак слова {знак}
помеха - кто чему {кто}
помешательство - Потеря рассудка {Потеря}
помидорина - плод помидора {плод}
помол - Превращение зерна {Превращение}
помолвка - Обряд объявления {Обряд}
поморник - Птица отряда {Птица}
поморы - население побережья {население}
поморяне - Жители поморья {Жители}
понос - Расстройство деятельности {Расстройство}
попадья - Жена попа {Жена}
попечительство - Система мероприятий {Система}
попка - части тела {части}
поплавок - Кусок пробки {Кусок}
поползень - птичка отряда {птичка}
попрошайничество - Собирание милостыни {Собирание}
популяция - Совокупность особей {Совокупность}
пора' - Время дня {Время}
пораженец - Сторонник пораженчества {Сторонник}
порок - недостаток уродство {недостаток}
поросенок - Детеныш свиньи {Детеныш}
поросль - побеги растений {побеги}
поросятина - Мясо поросенка {Мясо}
порошинка - крупинка пороха {крупинка}
портье - Служащий гостиницы {Служащий}
портянки - Куски ткани {Куски}
поручительство - Ручательство кого {Ручательство}
порцион - Количество продуктов {Количество}
порция - Количество кого {Количество}
поршень - Деталь двигателей {Деталь}
порыв - усиление (ветра {усиление}
порядок - Состояние налаженности {Состояние}
посадник - Наместник князя {Наместник}
посадничество - Должность посадника {Должность}
посвист - свист кого {свист}
поскачка - Бег борзой {Бег}
посконь - особь конопли {особь}
послабление - Снижение требовательности {Снижение}
посланница - Жена посланника {Жена}
постничество - Соблюдение постов {Соблюдение}
постпозиция - Положение какого {Положение}
постромки - Ремни (веревки {Ремни}
потенциал - Величина запаса {Величина}
потеря - Лишение чего {Лишение}
потолок - покрытие помещения {покрытие}
потроха - Внутренности животных {Внутренности}
потуги - сокращение мышц {сокращение}
поход - Передвижение какого {Передвижение}
почасовик - работа часов {работа}
почвообразование - Процесс образования {Процесс}
почвоутомление - Истощение почвы {Истощение}
почести - выражение уважения {выражение}
почесуха - Заболевание кожи {Заболевание}
почка - Зачаток побега {Зачаток}
почки - орган образования {орган}
почта - Учреждение связи {Учреждение}
почтамт - учреждение города {учреждение}
почтмейстерша - Жена почтмейстера {Жена}
пощада - Проявление сострадания {Проявление}
поэтика - Раздел теории {Раздел}
прабабушка - Мать деда {Мать}
правленец - Член правления {Член}
правнук - Сын внука {Сын}
правнучата - Правнуки правнучки {Правнуки}
правнучка - Дочь внука {Дочь}
право - Совокупность законов {Совокупность}
правобережье - берег реки {берег}
правоведение - Совокупность наук {Совокупность}
правонарушение - Нарушение права {Нарушение}
правописание - система правил {система}
правосознание - Совокупность взглядов {Совокупность}
правота - Правильность суждений {Правильность}
правщик - Работник типографии {Работник}
прагматика - Раздел семиотики {Раздел}
прагматист - Последователь прагматизма {Последователь}
прадед - Отец деда {Отец}
празднество - празднование чего {празднование}
праздник - День игр {День}
практика - совокупность приемов {совокупность}
прапрабабушка - Мать прадеда {Мать}
праправнук - Сын правнука {Сын}
праправнучка - Дочь правнука {Дочь}
прапрадед - Отец прадеда {Отец}
прародина - место обитания {место}
прасольство - Занятие прасола {Занятие}
прах - частицы чего {частицы}
пращур - предок родоначальник {предок}
превосходительство - титулование лиц {титулование}
предикативность - Наличие предиката {Наличие}
предмет - явление действительности {явление}
предназначение - назначение кому {назначение}
предопределенность - силой обстоятельств {силой}
предпринимательство - Деятельность предпринимателя {Деятельность}
предрасположение - Наличие каких {Наличие}
председательство - Исполнение обязанностей {Исполнение}
предсердие - отделов сердца {отделов}
представительство - Наличие представителей {Наличие}
предчувствие - чувство тревоги {чувство}
предшественник - деятельность кого {деятельность}
преемство - переход чего {переход}
преизбыток - избыток чего {избыток}
прейскурант - Справочник цен {Справочник}
прелиминарии - переговоры соглашения {переговоры}
премьер-министр - Глава правительства {Глава}
прения - Обсуждение какого {Обсуждение}
преосвященный - Титул епископа {Титул}
преосвященство - Титулование епископа {Титулование}
препинание - Знаки препинания# {Знаки}
преподавательство - Занятие преподавателя {Занятие}
преподобие - Титулование священника {Титулование}
препозиция - Положение какого {Положение}
пресвитерианство - Вероисповедание пресвитериан {Вероисповедание}
пресс-служба - Отдел сбора {Отдел}
престол - Трон монарха {Трон}
престолонаследие - Порядок наследования {Порядок}
престолонаследник - Наследник престола {Наследник}
преткновение - Камень преткновения# {Камень}
претор - титул консулов {титул}
преторианцы - охрана полководца {охрана}
префект - наименование ряда {наименование}
преференции - Преимущества льготы {Преимущества}
префиксация - Способ образования {Способ}
преходимость - характер чего {характер}
прибой - берег волны {берег}
прибор - устройство оборудования {устройство}
приборостроение - Отрасль машиностроения {Отрасль}
привередничество - Поведение того {Поведение}
приветствие - обращение (слова {обращение}
привидение - Призрак человека {Призрак}
привкус - вкус чего {вкус}
приворот - представлениямспособ привлечения {представлениямспособ}
привязанность - Чувство близости {Чувство}
пригарь - Привкус дыма {Привкус}
приживаемость - Способность организма {Способность}
призер - Участник состязания {Участник}
признательность - Чувство благодарности {Чувство}
призрак - Образ кого {Образ}
прииск - Место разработки {Место}
приискатель - Работник прииска {Работник}
приказ - распоряжение органа {распоряжение}
приказчик - служащий помещика {служащий}
приклад - конец ложа {конец}
прикус - Положение зубов {Положение}
прикуска - Порок лошади {Порок}
прилив - подъем уровня {подъем}
приличие - Соблюдение правил {Соблюдение}
прима - ступень звукоряда {ступень}
применимость - Возможность применения {Возможность}
применяемость - Наличие применения {Наличие}
примиренец - Сторонник примиренчества {Сторонник}
принужденность - Отсутствие простоты {Отсутствие}
принц - Титул члена {Титул}
принцип - положение какой {положение}
приовражье - Участок земли {Участок}
припадок - проявление чего {проявление}
приплод - Прибыль потомства {Прибыль}
приполок - поле рубашки {поле}
приросток - побег растения {побег}
прислуга - работница служанка {работница}
приспособленчество - Поведение приспособленца {Поведение}
пристук - такт чему {такт}
пристяжка - запряжки лошади {запряжки}
приток - Поступление жидкости {Поступление}
притяжение - явление тяготения {явление}
прихлебательство - Поведение прихлебателя {Поведение}
причастник - Участник чего {Участник}
причинность - связь явлений {связь}
прищипка - Удаление верхушки {Удаление}
проблематика - Совокупность проблем {Совокупность}
прободение - повреждение стенки {повреждение}
провиант - Продовольствие продукты {Продовольствие}
провизия - продукты продовольствие {продукты}
провинциал - Житель провинции {Житель}
провинциализм - Взгляды привычки {Взгляды}
проводимость - Способность вещества {Способность}
прогресс - Направление развития {Направление}
прогрессист - Сторонник прогресса {Сторонник}
прогрессия - ряд чисел {ряд}
продовольствие - Предметы питания {Предметы}
продувка - Очистка (какого {Очистка}
продукт - Предмет питания {Предмет}
продукция - Совокупность продуктов {Совокупность}
проект - план сооружения {план}
прожигатель - Прожигатель жизни# {Прожигатель}
проигрыш - исход игры {исход}
произношение - Воспроизведение звуков {Воспроизведение}
пройдоха - делах человек {делах}
прокат - Предоставление чего {Предоставление}
прокатка - Обработка металла {Обработка}
прокламация - Провозглашение обнародование {Провозглашение}
проклятие - осуждение кого {осуждение}
проконсул - Наместник провинции {Наместник}
прокурорство - Должность прокурора {Должность}
пролетаризация - условиях капитализма {условиях}
пролетарий - рабочий силы {рабочий}
пролонгация - Продление срока {Продление}
проминка - Вождение (лошади {Вождение}
промфинплан - план предприятия {план}
пропеллер - силу тяги {силу}
прописка - оформление проживания {оформление}
проповедник - Распространитель какого {Распространитель}
проповедничество - Деятельность проповедника {Деятельность}
пропорция - соотношение частей {соотношение}
прораб - Производитель работ {Производитель}
проросток - Стебель растения {Стебель}
прорость - Порок древесины {Порок}
просветительство - Деятельность просветителя {Деятельность}
просодия - Система произношения {Система}
просол - Качество засола {Качество}
простак - человек актера {человек}
простатит - Воспаление простаты {Воспаление}
простуда - Охлаждение организма {Охлаждение}
просып - просыпу Первенцев {просыпу}
просянка - птица отряда {птица}
протекционизм - политика государства {политика}
протекционист - Сторонник протекционизма {Сторонник}
протестант - Последователь протестантизма {Последователь}
противопоказание - показание кого {показание}
противостояние - Положение планеты {Положение}
протозоология - Раздел зоологии {Раздел}
протоистория - период жизни {период}
проток - Ответвление русла {Ответвление}
протоколизм - стиль изложения {стиль}
протон - частица вещества {частица}
протоплазма - Вещество животных {Вещество}
профан - области человек {области}
профанация - Искажение чего {Искажение}
профессионализм - Занятие чем {Занятие}
профессия - деятельности занятий {деятельности}
профессорство - Занятие профессора {Занятие}
профессорша - Жена профессора {Жена}
профилактика - Совокупность мероприятий {Совокупность}
проходимость - Доступность чего {Доступность}
процедура - последовательность действий {последовательность}
процесс - смена каких {смена}
прошествие - прошествии времени {прошествии}
прыжок - перемещение тела {перемещение}
прядь - Пучок волос {Пучок}
прямодушие - Отсутствие лицемерия {Отсутствие}
псина - мясо собаки {мясо}
психастения - расстройство психики {расстройство}
психиатрия - Раздел медицины {Раздел}
психоанализ - Метод психотерапии {Метод}
психогигиена - Раздел гигиены {Раздел}
психопатология - Раздел медицины {Раздел}
психофизика - Раздел психологии {Раздел}
псица - Самка собаки {Самка}
птенец - Детеныш птицы {Детеныш}
птицеловство - Ловля птиц {Ловля}
пуантилизм - манера живописи {манера}
пуд - мера веса {мера}
пульверизация - Распыление жидкости {Распыление}
пулька - Партия игры {Партия}
пульпит - Воспаление пульпы {Воспаление}
пульс - колебания стенок {колебания}
пунктуация - Система расстановки {Система}
пункция - Прокол какой {Прокол}
пуночка - птица отряда {птица}
пурист - Сторонник пуризма {Сторонник}
пустошь - участок земли {участок}
пустынножительство - Жизнь пустынножителя {Жизнь}
путч - попытка группы {попытка}
путь - Полоса земли {Полоса}
пушинка - частица чего {частица}
пушнина - Шкуры животных {Шкуры}
пуэрториканцы - население Пуэрто {население}
пчела - Насекомое отряда {Насекомое}
пшют - Хлыщ фат {Хлыщ}
пылеулавливание - Очистка воздуха {Очистка}
пылинка - Частица пыли {Частица}
пылища - количество пыли {количество}
пыльник - Плащ пальто {Плащ}
пыльца - Совокупность пылинок {Совокупность}
пэ - буквы «п {буквы}
пэр - Звание представителей {Звание}
пэрство - Звание пэра {Звание}
пядь - мера длины {мера}
пятерик - мера (счета {мера}
пятерня - Кисть руки {Кисть}
пятидесятилетие - Промежуток времени {Промежуток}
пятидневка - Промежуток времени {Промежуток}
пятилетие - Промежуток времени {Промежуток}
пятисотлетие - Промежуток времени {Промежуток}
рабфаковец - Учащийся рабфака {Учащийся}
раввин - Служитель культа {Служитель}
равновесие - Состояние неподвижности {Состояние}
радикал - Сторонник радикализма {Сторонник}
радикал - действие извлечения {действие}
радикулит - Воспаление корешков {Воспаление}
радиоастрономия - Раздел астрономии {Раздел}
радиография - метод обнаружения {метод}
радиология - Область медицины {Область}
радиолюбительство - Занятие любителей {Занятие}
радиометрия - Раздел физики {Раздел}
радиопередача - Передача чего {Передача}
радиотрансляция - Передача радиопрограмм {Передача}
радиофизика - Область физики {Область}
радиофикация - Развитие сети {Развитие}
радиохимия - Область химии {Область}
радиоцентр - Комплекс сооружений {Комплекс}
радиоэлектроника - совокупности ряда {совокупности}
радиус - Отрезок прямой {Отрезок}
радость - Чувство удовольствия {Чувство}
радуница - обычай поминания {обычай}
разведданные - Данные разведки {Данные}
разверстка - распределение кого {распределение}
разгильдяй - делах человек {делах}
разгром - поражение кого {поражение}
разлад - Отсутствие единства {Отсутствие}
размер - Величина чего {Величина}
разнобой - Отсутствие согласованности {Отсутствие}
разновес - Набор гирь {Набор}
разногласие - Отсутствие согласия {Отсутствие}
разноцветье - Разнообразие цветов {Разнообразие}
разночтение - Вариант какой {Вариант}
разочарование - Чувство неудовлетворенности {Чувство}
разряд - Группа род {Группа}
разум - деятельность человека {деятельность}
разумение - Постижение смысла {Постижение}
разъединенность - Отсутствие связи {Отсутствие}
райзо - Сокращение слов {Сокращение}
районо - Сокращение слов {Сокращение}
ракетостроение - Отрасль промышленности {Отрасль}
ракитник - кустарник заросли {кустарник}
рамоли","рамолик - слабоумие человек {слабоумие}
ранг - Степень отличия {Степень}
ранжир - Построение людей {Построение}
рант - полоска кожи {полоска}
раса - группа людей {группа}
расист - Сторонник расизма {Сторонник}
раскольник - Участник раскола {Участник}
раскомандировка - Распределение рабочих {Распределение}
расоведение - Раздел антропологии {Раздел}
распев - принцип строения {принцип}
расправа - применение силы {применение}
распутство - образ жизни {образ}
рассвет - Время суток {Время}
рассоление - Устранение засоления {Устранение}
расстройство - Состояние упадка {Состояние}
растворимость - Способность вещества {Способность}
растительность - Совокупность растений {Совокупность}
расточительство - трата чего {трата}
расцвет - Появление цветков {Появление}
ратман - Член органа {Член}
раунд - Промежуток времени {Промежуток}
рахитизм - Совокупность признаков {Совокупность}
рационализаторство - Деятельность рационализатора {Деятельность}
рационализация - Организация какой {Организация}
рационалист - Последователь рационализма {Последователь}
рвота - извержение содержимого {извержение}
реабилитация - Восстановление здоровья {Восстановление}
реаниматология - Раздел медицины {Раздел}
реанимация - Совокупность мероприятий {Совокупность}
рев - крик человека {крик}
реваншист - Сторонник реваншизма {Сторонник}
реверс - сторона медали {сторона}
реверсирование - Изменение направления {Изменение}
ревизионист - Последователь ревизионизма {Последователь}
регент - правитель государства {правитель}
регресс - Направление развития {Направление}
редукция - ние гласных {ние}
режиссер - руководитель спектакля {руководитель}
резервация - Сохранение чего {Сохранение}
резервист - военнообязанный резерва {военнообязанный}
резинка - Кусочек резины {Кусочек}
резонанс - Явление усиления {Явление}
резус - Обезьяна рода {Обезьяна}
резьба - обработка дерева {обработка}
резюме - изложение сути {изложение}
реинфекция - заражение организма {заражение}
рейтар - Солдат кавалерии {Солдат}
река - поток кого {поток}
реквизит - Совокупность вещей {Совокупность}
рекостав - Время замерзания {Время}
ректификация - Способ разделения {Способ}
ректор - Руководитель университета {Руководитель}
рекультивация - Восстановление плодородия {Восстановление}
реликвия - предмет почитания {предмет}
релятивист - Последователь релятивизма {Последователь}
ремарка - Замечание пометка {Замечание}
ремень - Полоса кожи {Полоса}
ремилитаризация - Вооружение государства {Вооружение}
ремиссия - ослабление проявлений {ослабление}
ремонт - Исправление повреждений {Исправление}
ремонт - Пополнение стада {Пополнение}
ренонс - отсутствие какой {отсутствие}
рентгенодиагностика - Распознавание заболеваний {Распознавание}
рентгенология - Раздел медицины {Раздел}
репатриация - Возвращение эмигрантов {Возвращение}
репертуар - Совокупность произведений {Совокупность}
репетиторство - Занятия репетитора {Занятия}
репняк - Ботва репы {Ботва}
репортаж - Составление сведений {Составление}
репортер - Сотрудник газеты {Сотрудник}
репрезентант - Представитель кого {Представитель}
репрезентация - Представительство кого {Представительство}
реприза","реприз - Повторение какого {Повторение}
репродукция - Воспроизведение чего {Воспроизведение}
рескрипт - силу закона {силу}
ресторатор - Владелец ресторана {Владелец}
ретина - оболочка глаза {оболочка}
ретинит - Воспаление ретины {Воспаление}
ретушь - Исправление изображения {Исправление}
рефлекс - Реакция организма {Реакция}
рефлектор - Отражатель лучей {Отражатель}
реформист - Сторонник реформизма {Сторонник}
рецензент - Автор рецензии {Автор}
рецепт - предписание врача {предписание}
рецептар - Служащий аптеки {Служащий}
рецептура - Совокупность сведений {Совокупность}
рецидив - Возврат болезни {Возврат}
решетина - прутьев полос {прутьев}
решетник - Материал (жерди {Материал}
решка - Сторона монеты {Сторона}
реэвакуация - Возвращение населения {Возвращение}
реэмиграция - Возвращение эмигрантов {Возвращение}
ржавость - Наличие ржавчины {Наличие}
ржание - Крик лошади {Крик}
риал - единица Ирана {единица}
ригоризм - соблюдение каких {соблюдение}
риза - облачение священника {облачение}
рикошет - Полет какого {Полет}
ринология - Раздел медицины {Раздел}
рисберма - Крепление русла {Крепление}
риск - опасность чего {опасность}
рисоводство - Разведение риса {Разведение}
ритм - Чередование каких {Чередование}
ритмизация - Введение ритма {Введение}
риторика - Теория красноречия {Теория}
ритуал - Совокупность обрядов {Совокупность}
рифление - Нанесение рифлей {Нанесение}
рифма - Созвучие окончаний {Созвучие}
рифмоплет - сочинитель стихов {сочинитель}
роббер - круг игры {круг}
рогач - Самец оленя {Самец}
рогожина - Кусок рогожи {Кусок}
родинка - изменение кожи {изменение}
родич - Член рода {Член}
родник - источник чего {источник}
роднички - участки черепа {участки}
родня - Родственники ","Родственник {Родственники}
родословие - История рода {История}
роды - процесс выхода {процесс}
рождаемость - Количество рождений {Количество}
розвязь - снопы связанности {снопы}
розга - ветка прутьев {ветка}
розовость - цвет чего {цвет}
рой - Семья пчел {Семья}
рол - цилиндр формы {цилиндр}
романистика - Совокупность наук {Совокупность}
романтик - Последователь романтизма {Последователь}
росинка - Капля чего {Капля}
ростовщичество - Занятие ростовщика {Занятие}
росток - Стебель растения {Стебель}
ротмистр - чин капитана {чин}
роялист - Сторонник роялизма {Сторонник}
рубило - орудие труда {орудие}
рубрика - Заголовок раздела {Заголовок}
руина - Развалины какого {Развалины}
рука - конечностей человека {конечностей}
рукоприкладство - Засвидетельствование чего {Засвидетельствование}
рулон - сверток (бумаги {сверток}
румянец - цвет щек {цвет}
руно - Шерсть овцы {Шерсть}
рупия - единица Индии {единица}
русистика - Совокупность наук {Совокупность}
русская - пляска русских {пляска}
рухлядь - негодность вещи {негодность}
рыболовство - Ловля рыбы {Ловля}
рында - звание оруженосца {звание}
рысенок - Детеныш рыси {Детеныш}
рябизна - окраска чего {окраска}
рябинник - роща заросли {роща}
ряд - Совокупность соединений {Совокупность}
рядность - порядок разделения {порядок}
саадак - Набор вооружения {Набор}
саботаж - срыв работы {срыв}
саботажничество - Поведение саботажника {Поведение}
сад - Участок земли {Участок}
садовничество - Занятие садовника {Занятие}
садоводство - Разведение садов {Разведение}
сажень - мера чего {мера}
сак - одежда полупальто {одежда}
саксаульник - Заросли саксаула {Заросли}
самобранка - Скатерть см {Скатерть}
самовластие - власть (правителя {власть}
самовозбуждение - возникновение каких {возникновение}
самоволие - Образ действий {Образ}
самовоспламенение - воспламенение топлива {воспламенение}
самодвижение - изменение системы {изменение}
самодержавие - власть монарха {власть}
самодурство - Образ действий {Образ}
самозабвение - Забвение себя {Забвение}
самозаготовка - Заготовка чего {Заготовка}
самокритика - Критика недостатков {Критика}
самолето-вылет - Вылет самолета {Вылет}
самолетостроение - Отрасль промышленности {Отрасль}
самообложение - сбор средств {сбор}
самооборона - Оборона страны {Оборона}
самообразование - Приобретение знаний {Приобретение}
самообучение - Обучение чему {Обучение}
самоокупаемость - Способ ведения {Способ}
самооправдание - Оправдание себя {Оправдание}
самоопыление - Опыление цветка {Опыление}
самоотравление - Отравление организма {Отравление}
саморазвитие - развитие человека {развитие}
самосев - обсеменение почвы {обсеменение}
самосогревание - возникновение тепла {возникновение}
самосплав - Сплав леса {Сплав}
самотек - Движение жидкости {Движение}
самоубийство - лишение себя {лишение}
самоумаление - Умаление себя {Умаление}
самоунижение - Унижение себя {Унижение}
самоуничижение - Уничижение себя {Уничижение}
самоуправление - Право какой {Право}
самоуспокоение - Успокоение себя {Успокоение}
самоуспокоенность - Отсутствие заботы {Отсутствие}
самоутверждение - Утверждение себя {Утверждение}
самочувствие - состояние человека {состояние}
сандвич - ломтика хлеба {ломтика}
сандружинница - Член сандружины {Член}
санкюлот - революционера участника {революционера}
сановница - Жена сановника {Жена}
сантименты - Проявление сентиментальности {Проявление}
сантиметр - Единица длины {Единица}
сап - заболевание лошадей {заболевание}
саранча - насекомое отряда {насекомое}
сатира - Способ проявления {Способ}
сатирик - Автор сатир {Автор}
сатурация - Насыщение жидкостей {Насыщение}
сахариметрия - Метод определения {Метод}
сахароварение - изготовление сахара {изготовление}
сбыт - Продажа чего {Продажа}
сбыточность - Возможность осуществления {Возможность}
свадьба - Обряд заключения {Обряд}
сваны - группа грузин {группа}
сварение - Переваривание пищи {Переваривание}
свариваемость - Способность металла {Способность}
сварка - Процесс получения {Процесс}
све'дение - Известия сообщения {Известия}
свеклосеяние - Посев свеклы {Посев}
свекор - Отец мужа {Отец}
свекровь - Мать мужа {Мать}
сверчок - Насекомое отряда {Насекомое}
светильник - устройств приборов {устройств}
светобоязнь - чувствительность глаза {чувствительность}
светокопирование - Изготовление светокопий {Изготовление}
светокопия - Копия чертежа {Копия}
светосила - Степень освещенности {Степень}
светотехника - Область техники {Область}
свечение - Излучение света {Излучение}
свивальник - полоса ткани {полоса}
свидание - Встреча влюбленных {Встреча}
свиль - расположение слоев {расположение}
свинина - Мясо свиньи {Мясо}
свиноводство - Разведение свиней {Разведение}
свинцевание - Нанесение слоя {Нанесение}
свирель - инструмент типа {инструмент}
свиристель - птица отряда {птица}
свистопляска","свистопляс - проявление чего {проявление}
свиток - Полоса бумаги {Полоса}
свобода - Способность человека {Способность}
свободомыслие - образ мыслей {образ}
своеобразие - особенность кого {особенность}
сворот - Поворот (дороги {Поворот}
свояченица - Сестра жены {Сестра}
связист - Работник связи {Работник}
священнодействие - Отправление богослужения {Отправление}
сеанс - демонстрация чего {демонстрация}
север - стран государства {стран}
севрюжина - Мясо севрюги {Мясо}
сегментация - строение тела {строение}
сеголетки","сеголетка - Молодняк (птицы {Молодняк}
седок - Всадник верховой {Всадник}
сезон - времен года {времен}
сезонность - Возможность осуществления {Возможность}
сеид - титул мусульманина {титул}
сейсмограмма - Результат записи {Результат}
сейсмология - Раздел геофизики {Раздел}
сейсмометрия - Раздел сейсмологии {Раздел}
секанс - функций угла {функций}
секвенция - Повторение какого {Повторение}
секретариат - Отдел какого {Отдел}
секретарство - Исполнение обязанностей {Исполнение}
сектант - Член какой {Член}
сектантство - групп общин {групп}
секунда - Единица измерения {Единица}
селезень - Самец утки {Самец}
селекция - Раздел агрономии {Раздел}
селенодезия - Раздел планетологии {Раздел}
селенология - Раздел планетологии {Раздел}
селитра - нитратов аммония {нитратов}
селище - Место поселения {Место}
селькорство - Работа обязанности {Работа}
семантика - Значение (слова {Значение}
семасиология - Раздел языкознания {Раздел}
семеноводство - Отрасль растениеводства {Отрасль}
семерик - мера (счета {мера}
семидесятилетие - Промежуток времени {Промежуток}
семидесятипятилетие - Промежуток времени {Промежуток}
семидневка - Промежуток времени {Промежуток}
семилетие - Промежуток времени {Промежуток}
семинар - занятия студентов {занятия}
семинарист - Ученик семинарии {Ученик}
семиполье - Система севооборота {Система}
семисотлетие - Промежуток времени {Промежуток}
семитология - Совокупность наук {Совокупность}
семиты - Группа народов {Группа}
семья - Группа животных {Группа}
семядоли - листья зародыша {листья}
семяпочка - Зародыш семени {Зародыш}
сенатор - Член сената {Член}
сенозаготовки - Заготовка сена {Заготовка}
сенокос - Косьба травы {Косьба}
сенокошение - Косьба травы {Косьба}
сенсибилизация - Повышение чувствительности {Повышение}
сенсуалист - Последователь сенсуализма {Последователь}
сентименталист - Представитель сентиментализма {Представитель}
сеньор - Наименование мужчины {Наименование}
сепаратист - Сторонник сепаратизма {Сторонник}
сепаратор - аппаратов служащих {аппаратов}
серафим - ангел чина {ангел}
сервиз - набор столовой {набор}
сервис - обслуживание населения {обслуживание}
сервитут - право пользования {право}
сердце - орган кровообращения {орган}
сердцебиение - биение сердца {биение}
сердяга - человека лица {человека}
серийность - Организация производства {Организация}
серия - Ряд изделий {Ряд}
серозем - почв полупустынь {почв}
серотерапия - Лечение заболеваний {Лечение}
серповище - Рукоятка серпа {Рукоятка}
сетевязание - Вязание сетей {Вязание}
сеттльмент - район города {район}
сетчатка - оболочка глаза {оболочка}
сжимаемость - изменение объема {изменение}
сибарит - роскошью человек {роскошью}
сибаритство - Образ жизни {Образ}
сиделец - Приказчик продавец {Приказчик}
сила - Способность человека {Способность}
силикоз - болезнь горняков {болезнь}
силуэт - изображение кого {изображение}
силуэтность - очертания (здания {очертания}
символист - Последователь символизма {Последователь}
симметрия - расположение частей {расположение}
симптоматика - Совокупность симптомов {Совокупность}
синдикалист - Сторонник синдикализма {Сторонник}
синдром - сочетание признаков {сочетание}
синедрион - Совет старейшин {Совет}
синец - Рыба рода {Рыба}
синица - птица отряда {птица}
синклиналь - Складка пластов {Складка}
синонимика - Совокупность синонимов {Совокупность}
синонимия - Сходство слов {Сходство}
синопсис - Сборник сведений {Сборник}
синтаксис - Строение предложения {Строение}
синус - функций угла {функций}
синьор - Наименование мужчины {Наименование}
синьория - Орган самоуправления {Орган}
синюха - цвет кожи {цвет}
сионист - Приверженец сионизма {Приверженец}
сипота - Сиплость голоса {Сиплость}
сирийцы - Арабы Сирии {Арабы}
сироп - раствор сахара {раствор}
система - Множество элементов {Множество}
систематизация - Приведение чего {Приведение}
ситуация - Совокупность условий {Совокупность}
сиятельство - титулование князей {титулование}
сказочник - Рассказчик сказок {Рассказчик}
сказуемое - членов предложения {членов}
сказуемость - Свойство сказуемого {Свойство}
скандинавистика - Комплекс наук {Комплекс}
скарификация - обработка семян {обработка}
скачка - бег лошади {бег}
сквозняк - тяга воздуха {тяга}
скворец - птица отряда {птица}
скворчиха - Самка скворца {Самка}
скворчонок - Птенец скворца {Птенец}
скелет - Совокупность костей {Совокупность}
скептик - Последователь скептицизма {Последователь}
скерцо - произведение (симфонии {произведение}
скит - кельи монахов {кельи}
скитальчество - образ жизни {образ}
склад - количество каких {количество}
складчина - Внесение денег {Внесение}
склера - оболочка глаза {оболочка}
склероз - процесс уплотнения {процесс}
склянка - промежуток времени {промежуток}
скованность - Отсутствие свободы {Отсутствие}
сколок - кусок чего {кусок}
скоп - Скопление кого {Скопление}
скопчество - Состояние кастрата {Состояние}
скорлупа - оболочка чего {оболочка}
скороспелка - плод чем {плод}
скороспелость - Способность животных {Способность}
скорость - Степень быстроты {Степень}
скорпион - животное класса {животное}
скотоводство - Отрасль животноводства {Отрасль}
скотоподобие - образ жизни {образ}
скотство - образ жизни {образ}
скрещиваемость - Возможность получения {Возможность}
скрип - звук пения {звук}
скудоумие - Слабость ума {Слабость}
скученность - скопление кого {скопление}
слабоволие - сила воли {сила}
славка - птичка отряда {птичка}
славословие - восхваление кого {восхваление}
славяноведение - Совокупность наук {Совокупность}
славянофил - Сторонник славянофильства {Сторонник}
слагатель - Сочинитель (песен {Сочинитель}
сладкогласие - голос (голоса {голос}
слеза - жидкость сока {жидкость}
слепок - копия кого {копия}
слепота - отсутствие зрения {отсутствие}
слива - дерево кустарника {дерево}
сливки - отстой молока {отстой}
слобожанин - Житель слободы {Житель}
словесность - литература слова {литература}
слово - Единица речи {Единица}
словоизменение - Изменение слов {Изменение}
словообразование - Образование слов {Образование}
словоупотребление - Употребление слова {Употребление}
слой - Пласт чего {Пласт}
слоненок - Детеныш слона {Детеныш}
слониха - Самка слона {Самка}
слышимость - Степень отчетливости {Степень}
слюноотделение - Выделение слюны {Выделение}
слюнотечение - выделение слюны {выделение}
смерть - Прекращение существования {Прекращение}
сметки - Остатки чего {Остатки}
смешиваемость - Способность веществ {Способность}
смешок - смех шутки {смех}
смоква - Плод смоковницы {Плод}
смолокурение - Выгонка смолы {Выгонка}
смолье - дрова щепки {дрова}
смородина - кустарник ягоды {кустарник}
смородинник - Заросли смородины {Заросли}
смотр - осмотр чего {осмотр}
смотрины - знакомство жениха {знакомство}
снабженец - Работник отдела {Работник}
снаряд - Совокупность предметов {Совокупность}
снасть - Совокупность инструментов {Совокупность}
снегириха - Самка снегиря {Самка}
снеговал - Выворачивание деревьев {Выворачивание}
снегование - способ хранения {способ}
снегозадержание - задержание снега {задержание}
снеголом - Сламывание стволов {Сламывание}
снегопад - Выпадение снега {Выпадение}
снеготаяние - Таяние снега {Таяние}
снежинка - Кристаллик льда {Кристаллик}
снос - Сносу (сноса {Сносу}
сноха - Жена сына {Жена}
собаководство - Отрасль животноводства {Отрасль}
собачина - Мясо собаки {Мясо}
собес - обеспечение учреждения {обеспечение}
собирательство - Собирание коллекции {Собирание}
соболеводство - Разведение соболей {Разведение}
соболенок - Детеныш соболя {Детеныш}
собственник - Владелец какой {Владелец}
совенок - Птенец совы {Птенец}
совик - одежда мужчины {одежда}
совка - Птица отряда {Птица}
совладение - владение чем {владение}
совпадение - Одновременность каких {Одновременность}
сожаление - Чувство огорчения {Чувство}
созвездие - Группа звезд {Группа}
соискатель - Участник конкурса {Участник}
сойка - птица отряда {птица}
сокол - Инструмент штукатура {Инструмент}
соколенок - Птенец сокола {Птенец}
соколиха - Самка сокола {Самка}
сократимость - Свойство чисел {Свойство}
сокровищница - Место сосредоточения {Место}
солдатка - Жена солдата {Жена}
солеварение - Добывание соли {Добывание}
соледобывание - Добывание соли {Добывание}
солидарность - сочувствие каким {сочувствие}
солипсист - Последователь солипсизма {Последователь}
солнцепек - Время дня {Время}
солнцестояние - Момент времени {Момент}
соло - произведение танцев {произведение}
соловьиха - Самка соловья {Самка}
соломина - стебель соломы {стебель}
сольдо - монета Португалии {монета}
солянка - трав кустарников {трав}
соматология - Раздел антропологии {Раздел}
сомнамбулизм - Расстройство сознания {Расстройство}
сомовина - Мясо сома {Мясо}
сон - промежутки времени {промежутки}
сообщество - Объединение лиц {Объединение}
сообщник - Соучастник преступления {Соучастник}
сопель - инструмент типа {инструмент}
сопка - холма горы {холма}
соприкосновение - Положение предметов {Положение}
сопромат - Сопротивление материалов {Сопротивление}
соринка - Частичка сора {Частичка}
сорность - Степень засоренности {Степень}
сородич - Родственник родич {Родственник}
сорокалетие - Промежуток времени {Промежуток}
сороковка - мера жидкостей {мера}
сорокопут - птица отряда {птица}
сорокоуст - чтение молитв {чтение}
сортамент - размер изделий {размер}
сословие - группа лиц {группа}
сословность - Деление общества {Деление}
сосняк - лес бревна {лес}
сосредоточенность - Скопление кого {Скопление}
состав - Совокупность людей {Совокупность}
сосун - Детеныш млекопитающего {Детеныш}
сосуществование - существование кого {существование}
сотник - Начальник сотни {Начальник}
сотня - Единица счета {Единица}
софист - учитель философии {учитель}
соцветие - Совокупность цветков {Совокупность}
социал-демократ - Сторонник социал-демократии {Сторонник}
социализм - фаза коммунизма {фаза}
социалист - Последователь социализма {Последователь}
спайность - Способность большинства {Способность}
спасибо - выражение благодарности {выражение}
спевка - Репетиция хора {Репетиция}
спектакль - представление каком {представление}
спектрограмма - Фотоснимок спектра {Фотоснимок}
спектроскопия - Раздел физики {Раздел}
спекуляция - Скупка товаров {Скупка}
спец - специалиста выходца {специалиста}
специальность - отрасль науки {отрасль}
спецкурс - Курс лекций {Курс}
спикер - Председатель палаты {Председатель}
спилок - Слой кожи {Слой}
спиритуалист - Последователь спиритуализма {Последователь}
спирография - Регистрация объема {Регистрация}
спирохеты - Микроорганизмы клетки {Микроорганизмы}
сплоток - Бревна доски {Бревна}
сплошняк - масса чего {масса}
сплюшка - птица отряда {птица}
спокойствие - Состояние природы {Состояние}
спондилез - заболевание позвоночника {заболевание}
спондилит - заболевание позвоночника {заболевание}
спорангий - Орган размножения {Орган}
споровики - животных типа {животных}
спорок - верх платья {верх}
спорофилл - лист хвощей {лист}
спортивки - Легкие туфли {Легкие}
способ - Образ действий {Образ}
справа - Дело занятие {Дело}
спурт - увеличение темпа {увеличение}
сработанность - Степень изношенности {Степень}
сражение - столкновение войск {столкновение}
ссуда - Предоставление денег {Предоставление}
ссыльнопоселенец - России лица {России}
стабилизация - Приведение чего {Приведение}
ставка - Место расположения {Место}
ставрида - рыба отряда {рыба}
стадиальность - Наличие стадий {Наличие}
стадо - Группа животных {Группа}
стаж - Продолжительность пребывания {Продолжительность}
стакан - сосуд деталей {сосуд}
стан - Место стоянки {Место}
станичник - Житель станицы {Житель}
станкостроение - отрасль машиностроения {отрасль}
станция - Пункт остановки {Пункт}
старостиха - Жена старосты {Жена}
старпом - помощник капитана {помощник}
старт - момент взлета {момент}
статика - Раздел механики {Раздел}
статут - Свод правил {Свод}
статуя - изображение человека {изображение}
стать - склад фигуры {склад}
стация - Место обитания {Место}
стачка - прекращение работы {прекращение}
стая - Группа животных {Группа}
стекло - вещество частицы {вещество}
стеклоделие - Производство стекла {Производство}
стекляшка - Кусочек стекла {Кусочек}
стеноз - Сужение просвета {Сужение}
стенолаз - Птица отряда {Птица}
стерва - Труп животного {Труп}
стереобат - основание храма {основание}
стереотипия - Процесс изготовления {Процесс}
стерилизация - Уничтожение микроорганизмов {Уничтожение}
стерлинг - стандарт пробы {стандарт}
стерляжина - Мясо стерляди {Мясо}
стило - Орудие письма {Орудие}
стиль - Совокупность приемов {Совокупность}
стиль - Способ летосчисления {Способ}
стильб - Единица яркости {Единица}
стихия - элементов природы {элементов}
стихология - Раздел метрики {Раздел}
стихоплет - сочинитель стихов {сочинитель}
стихосложение - Сочинение стихов {Сочинение}
стихотворец - Сочинитель стихов {Сочинитель}
стихотворчество - Писание стихов {Писание}
стланье - обработки льна {обработки}
стог - копна сена {копна}
стогны - улицы площади {улицы}
стогометание - Складывание сена {Складывание}
стоик - Последователь философии {Последователь}
стойка - Положение тела {Положение}
столбец - Ряд слов {Ряд}
столетие - Промежуток времени {Промежуток}
столетник - растений алоэ {растений}
стоматология - Раздел медицины {Раздел}
стоп-сигнал - прибор автомобиля {прибор}
стопа - единица стиха {единица}
стопа - Совокупность предметов {Совокупность}
страдивариус","страдиварий - Скрипка работы {Скрипка}
страница - сторона листа {сторона}
стратегия - Искусство руководства {Искусство}
стратификация - строение чего {строение}
стратосфера - Слой атмосферы {Слой}
страусенок - Птенец страуса {Птенец}
стрепет - птица отряда {птица}
стресс - Состояние напряжения {Состояние}
стреха - край крыши {край}
стриптиз - представление участницы {представление}
строительство - Возведение зданий {Возведение}
строй - Ряд предметов {Ряд}
строка - Ряд слов {Ряд}
строфа - Сочетание стихов {Сочетание}
строфика - Раздел стиховедения {Раздел}
стружка - слой дерева {слой}
структуралист - Последователь структурализма {Последователь}
струя - поток (воздуха {поток}
студиец - Ученик студии {Ученик}
студия - Мастерская художника {Мастерская}
стык - Место соединения {Место}
стяжательство - накопление денег {накопление}
субалтерн-офицер - офицер роты {офицер}
суббота - день недели {день}
субботник - выполнение какой {выполнение}
сублимат - Продукт сублимации {Продукт}
сублимация - переход вещества {переход}
субъективист - Последователь субъективизма {Последователь}
суверенитет - независимость государства {независимость}
суданцы - Население Судана {Население}
судачина - Мясо судака {Мясо}
судебник - Собрание законов {Собрание}
судейство - Исполнение обязанностей {Исполнение}
судовождение - Искусство вождения {Искусство}
судоговорение - изложение дела {изложение}
судоремонт - Ремонт судов {Ремонт}
судоустройство - Структура системы {Структура}
судоходство - Плавание судов {Плавание}
судьба - воли человека {воли}
суемудрие - рассуждения умствования {рассуждения}
сук - отросток ствола {отросток}
сукноделие - Производство сукон {Производство}
суконка - Лоскут сукна {Лоскут}
султанат - Власть султана {Власть}
сульфиды - Соединения серы {Соединения}
сульфитация - Консервирование плодов {Консервирование}
сумасшествие - Потеря рассудка {Потеря}
сумбур - Отсутствие ясности {Отсутствие}
сумма - Результат сложения {Результат}
супрематизм - искусства начала {искусства}
супрематист - Последователь супрематизма {Последователь}
супряга - обработка земли {обработка}
сурдопедагогика - Отрасль дефектологии {Отрасль}
сурчина - Нора сурка {Нора}
сусаль - листы золота {листы}
сутки - Единица измерения {Единица}
сутулина - сутулость спины {сутулость}
суфлер - Работник театра {Работник}
суффиксация - Образование слов {Образование}
сухарь - кусок хлеба {кусок}
суховершинность - Усыхание верхушек {Усыхание}
сухолюбивость - Приспособленность растений {Приспособленность}
сухота - Ощущение сухости {Ощущение}
сушь - погода ветки {погода}
существо - организм человек {организм}
существование - Наличие кого {Наличие}
сфигмография - запись пульса {запись}
сходка - Собрание членов {Собрание}
схоласт - Последователь схоластики {Последователь}
сценарист - Автор сценария {Автор}
сценариус - Помощник режиссера {Помощник}
счетоводство - Ведение учета {Ведение}
сыгровка - Репетиция оркестра {Репетиция}
сыроделие - Производство сыра {Производство}
сыромолот - Обмолот зерна {Обмолот}
сыч - птица отряда {птица}
сычуг - отделов желудка {отделов}
сюжетность - Наличие сюжета {Наличие}
сюрреалист - Последователь сюрреализма {Последователь}
табельщик - Работник предприятия {Работник}
табор - расположение войска {расположение}
табу - запрет что {запрет}
табун - Стадо лошадей {Стадо}
такелаж - Снасти судна {Снасти}
такса - расценка товаров {расценка}
таксация - Установление размеров {Установление}
таксидермия - Изготовление чучел {Изготовление}
таксист - Водитель такси {Водитель}
таксономия - Теория классификации {Теория}
такт - Чувство меры {Чувство}
талька - Моток ниток {Моток}
тальник - ива ветви {ива}
тамада - Распорядитель пира {Распорядитель}
тамбурин - инструмент род {инструмент}
таможенник - Служащий таможни {Служащий}
тангенс - функций угла {функций}
танкодром - Участок местности {Участок}
танцкласс - Школа танцев {Школа}
танцмейстер - Учитель танцев {Учитель}
тапки - легких туфель {легких}
тарбаган - Грызун рода {Грызун}
тариф - размер стоимости {размер}
тарификация - Определение тарифа {Определение}
тартар - царство мертвых {царство}
тартинка - ломтик хлеба {ломтик}
тахикардия - Увеличение частоты {Увеличение}
тве'рдо - буквы «т {буквы}
творчество - Деятельность человека {Деятельность}
театрал - Любитель театра {Любитель}
тебеневка - пастьба лошадей {пастьба}
тезаврация - Накопление золота {Накопление}
теист - Последователь теизма {Последователь}
тейлоризм - Система организации {Система}
текст - Слова предложения {Слова}
текстиль - изделия ткани {изделия}
текстология - Раздел филологии {Раздел}
текстура - Особенности строения {Особенности}
тектоника - Строение какого {Строение}
телеграфист - Работник телеграфа {Работник}
телеграфия - Область науки {Область}
телемеханизация - Применение средств {Применение}
теленок - Детеныш оленя {Детеныш}
теленомус - насекомое вредителей {насекомое}
телеобъектив - объектив фото {объектив}
телепатия - явление передачи {явление}
телепередача - Передача изображения {Передача}
телеса - Тело толстяка {Тело}
телефония - Область науки {Область}
телодвижение - Движение тела {Движение}
телосложение - Строение формы {Строение}
телятина - Мясо теленка {Мясо}
тема - Предмет разговора {Предмет}
темница - Место заключения {Место}
темнота - Отсутствие света {Отсутствие}
темп - Степень быстроты {Степень}
температура - Степень теплоты {Степень}
тенденциозность - Наличие тенденции {Наличие}
теория - обобщение опыта {обобщение}
теософ - Последователь теософии {Последователь}
тепловозостроение - Отрасль промышленности {Отрасль}
теплоемкость - Количество теплоты {Количество}
теплолечение - Применение тепла {Применение}
теплообмен - процесс переноса {процесс}
теплоотдача - Отдача тепла {Отдача}
теплопровод - Система труб {Система}
теплопроводность - Свойство тел {Свойство}
теплоснабжение - снабжение потребителей {снабжение}
теплостойкость - Способность тела {Способность}
теплотехника - Отрасль техники {Отрасль}
теплоэнергетика - Отрасль теплотехники {Отрасль}
терминология - Совокупность терминов {Совокупность}
термит - смесь алюминия {смесь}
термиты - Отряд насекомых {Отряд}
термодинамика - Раздел физики {Раздел}
термометрия - Раздел физики {Раздел}
терние - растение препятствия {растение}
территория - пространство земли {пространство}
террор - Политика устрашения {Политика}
терьер - пород собак {пород}
тесина - доска теса {доска}
тесло - орудие род {орудие}
тесситура - положение звуков {положение}
тетерев - птица отряда {птица}
тетерка - Самка тетерева {Самка}
тетка - Сестра отца {Сестра}
техника - Совокупность орудий {Совокупность}
технология - Совокупность операций {Совокупность}
течь - Проникновение воды {Проникновение}
теща - Мать жены {Мать}
тиара - убор папы {убор}
тигренок - Детеныш тигра {Детеныш}
тигрица - Самка тигра {Самка}
тик - подергивание мышц {подергивание}
тимпан - поле фронтона {поле}
тимпан - инструмент (род {инструмент}
типаж - Совокупность признаков {Совокупность}
типометрия - система мер {система}
типун - Болезнь птиц {Болезнь}
тираж - количество экземпляров {количество}
тираж - Розыгрыш выигрышей {Розыгрыш}
тиран - правитель действия {правитель}
тире - Знак препинания {Знак}
тирс - жезл Диониса {жезл}
титестер - Дегустатор чая {Дегустатор}
титул - звание какой {звание}
титулование - Называние кого {Называние}
тифлопедагогика - Раздел дефектологии {Раздел}
тишина - Отсутствие вражды {Отсутствие}
ткачество - Изготовление ткани {Изготовление}
ткемали - дерево рода {дерево}
товар - Продукт труда {Продукт}
товарищество - Группа лиц {Группа}
товарооборот - Обращение товаров {Обращение}
тога - одежда граждан {одежда}
токсемия - Отравление организма {Отравление}
токсикоз - состояние организма {состояние}
токсикология - Раздел медицины {Раздел}
толпа - скопление людей {скопление}
толстовец - Последователь толстовства {Последователь}
тон - Характеристика звука {Характеристика}
тональность - Высота звуков {Высота}
тонзиллит - Воспаление небных {Воспаление}
тонмейстер - Работник радиовещания {Работник}
тонна - Единица массы {Единица}
тонно-километр - Единица грузооборота {Единица}
тонно-миля - Единица грузооборота {Единица}
тоня - Участок водоема {Участок}
топ - конец мачты {конец}
топология - Раздел математики {Раздел}
топорище - Рукоятка топора {Рукоятка}
топчан - кровати койки {кровати}
торба - Мешок сума {Мешок}
торгашество - Занятие торгаша {Занятие}
тореадор - Участник боя {Участник}
торец - срез бревна {срез}
торжище - Место торговли {Место}
торнадо - смерчей (тромбов {смерчей}
торосистость - Наличие торосов {Наличие}
торс - Туловище человека {Туловище}
торфование - Удобрение почвы {Удобрение}
торфоразработки - Место добычи {Место}
торфяник - Залежь торфа {Залежь}
траверс - Переход альпинистов {Переход}
травля - Преследование зверя {Преследование}
травма - Повреждение тканей {Повреждение}
травматология - Раздел медицины {Раздел}
травостой - покров лугов {покров}
траектория - Линия полета {Линия}
трактирщик - Хозяин трактира {Хозяин}
тракторизация - Внедрение тракторов {Внедрение}
тракторист - Водитель трактора {Водитель}
тракторостроение - Отрасль машиностроения {Отрасль}
транжирство - трата денег {трата}
транзит - Перевозка грузов {Перевозка}
транс - Помрачение сознания {Помрачение}
трансгрессия - Наступление моря {Наступление}
транскрипция - передача звуков {передача}
транслитерация - Передача букв {Передача}
трансплантация - Пересадка части {Пересадка}
транспо'рт - Перенос суммы {Перенос}
транспортник - Работник транспорта {Работник}
трансформизм - Система представлений {Система}
трансфузия - Переливание (крови {Переливание}
трахеотомия - вскрытие трахеи {вскрытие}
трахея - горло трубочки {горло}
трахома - заболевание конъюнктивы {заболевание}
треба - обряд принесения {обряд}
тред-юнионист - Сторонник тред-юнионизма {Сторонник}
трение - Движение предмета {Движение}
трепанация - Операция вскрытия {Операция}
треста - стебли конопли {стебли}
трехлетие - Промежуток времени {Промежуток}
трехлеток","трехлетка - Кто что {Кто}
трехполье - система севооборота {система}
трехсменка - Работа предприятия {Работа}
трехсотлетие - Промежуток времени {Промежуток}
триангуляция - Разбивка поверхности {Разбивка}
трибунал - орган судьи {орган}
тригонометрия - Раздел математики {Раздел}
тридцатилетие - Промежуток времени {Промежуток}
трио - произведение (вальса {произведение}
триплет - систем устройств {систем}
трипсин - Фермент сока {Фермент}
тритий - изотоп водорода {изотоп}
триумвир - Участник триумвирата {Участник}
триумф - встреча полководца {встреча}
трихина - червь личинки {червь}
трихинеллез - Заболевание животных {Заболевание}
трихофития - заболевание кожи {заболевание}
тромб - Сгусток крови {Сгусток}
тромбоз - Процесс образования {Процесс}
тромбофлебит - Воспаление стенки {Воспаление}
трон - Место монарха {Место}
тропосфера - слой атмосферы {слой}
тростинка - Стебель тростника {Стебель}
трость - Стебель тростника {Стебель}
троцкист - Последователь троцкизма {Последователь}
трубковерты - сем жуков {сем}
трубоволочение - Производство труб {Производство}
трубочист - Чистильщик труб {Чистильщик}
труд - деятельность человека {деятельность}
трудодень - Единица учета {Единица}
труп - тело человека {тело}
труппа - Коллектив артистов {Коллектив}
трусость - Чувство страха {Чувство}
трясогузка - птица отряда {птица}
тугоухость - потеря слуха {потеря}
тук - Жир сало {Жир}
туловище - Тело человека {Тело}
тулумбас - инструмент род {инструмент}
туляремия - заболевание животных {заболевание}
тумак - Помесь зайца {Помесь}
тумба - столбик (подставки {столбик}
туника - одежда род {одежда}
туннелестроение","тоннелестроение - Сооружение туннелей {Сооружение}
тур - круг чего {круг}
турбостроение - Отрасль машиностроения {Отрасль}
турухтан - птица отряда {птица}
тутоводство - Разведение шелковицы {Разведение}
туше - Манера прикосновения {Манера}
тушканчик - животное отряда {животное}
тщета - Отсутствие смысла {Отсутствие}
тыквина - штука тыквы {штука}
тысячелетие - Промежуток времени {Промежуток}
тычинка - орган размножения {орган}
тэ - буквы «т {буквы}
тюлененок - Детеныш тюленя {Детеныш}
тюленина - Мясо тюленя {Мясо}
тюрбо - рыба отряда {рыба}
тюрьма - Место заключения {Место}
тягло - повинности крестьян {повинности}
убожество - недостаток уродство {недостаток}
убой - Убивание скота {Убивание}
увалень - движениях человек {движениях}
угар - газ самозабвения {газ}
углекислота - двуокиси углерода {двуокиси}
углеобразование - Процесс образования {Процесс}
угодье - Участок земли {Участок}
угомон - Угомон тебя {Угомон}
угорье - Подножие горы {Подножие}
удар - толчок сотрясения {толчок}
ударение - Выделение слова {Выделение}
удовольствие - Чувство радости {Чувство}
удой - Количество молока {Количество}
ужимки - телодвижения гримасы {телодвижения}
ужонок - Детеныш ужа {Детеныш}
узел - единица скорости {единица}
узкоглазие - разрез глаз {разрез}
узколобие - Ограниченность взглядов {Ограниченность}
узурпаторство - Поведение узурпатора {Поведение}
узурпация - захват власти {захват}
укрывательство - скрытие преступника {скрытие}
уложение - Свод законов {Свод}
улыбка - Движение мышц {Движение}
ультиматист - Сторонник ультиматизма {Сторонник}
ультиматум - требование чего {требование}
ум - способность человека {способность}
умозаключение - процесс выведения {процесс}
умолот - Количество зерна {Количество}
умонастроение - Направленность ума {Направленность}
умопомешательство - Потеря рассудка {Потеря}
уморение - Обработка волоса {Обработка}
умыкание - заключения брака {заключения}
универсам - магазин самообслуживания {магазин}
уникум - экземпляр чего {экземпляр}
униформист - Работник цирка {Работник}
унтер-офицерша - Жена унтер-офицера {Жена}
унция - Мера веса {Мера}
уныние - состояние духа {состояние}
упад - упаду (упада {упаду}
упадочник - Выразитель эпохи {Выразитель}
упадочничество - взгляды настроения {взгляды}
упитанность - Состояние организма {Состояние}
упоение - Состояние восторга {Состояние}
упокой - упокой раба {упокой}
уполномочие - уполномочию кого {уполномочию}
упряжь - Совокупность приспособлений {Совокупность}
урбанизация - Процесс повышения {Процесс}
урбанист - Последователь урбанизма {Последователь}
урду - язык Индии {язык}
уремия - отравление организма {отравление}
уретрит - Воспаление уретры {Воспаление}
уретроскопия - Метод исследования {Метод}
уродство - недостаток организма {недостаток}
урология - Раздел медицины {Раздел}
усадка - Уменьшение тела {Уменьшение}
усадьба - Совокупность строений {Совокупность}
услужник - Слуга служитель {Слуга}
успеваемость - Степень успешности {Степень}
уста - Рот губы {Рот}
устав - Свод правил {Свод}
устье - Место впадения {Место}
усыпальница - Место погребения {Место}
утварь - Совокупность предметов {Совокупность}
утенок - Птенец утки {Птенец}
утилитарист - Последователь утилитаризма {Последователь}
утиль - Отходы вещи {Отходы}
уток - нити ткани {нити}
утомление - Ослабление сил {Ослабление}
утопизм - Построение планов {Построение}
утопист - Автор какой {Автор}
утруска - Уменьшение веса {Уменьшение}
утятина - Мясо утки {Мясо}
ухарь - поступки человек {поступки}
ухватка - Характер телодвижений {Характер}
ухо - Орган слуха {Орган}
участие - деятельность долей {деятельность}
участь - Положение кого {Положение}
учительша - Учительница учителя {Учительница}
фабула - схема событий {схема}
фавн - бог полей {бог}
фаворит - Любимец какого {Любимец}
фагоциты - клетки животных {клетки}
фаза - стадия чего {стадия}
фазан - птица отряда {птица}
фазанка - Самка фазана {Самка}
фазановые - птиц отряда {птиц}
факсимиле - воспроизведение рукописи {воспроизведение}
фактография - Описание фактов {Описание}
фаланга - порядок пехоты {порядок}
фальсификация - Подделывание чего {Подделывание}
фальшборт - ограждение палубы {ограждение}
фамилия - наименование человека {наименование}
фанатизм - Образ мыслей {Образ}
фанера - листы древесины {листы}
фантасмагория - картины фигуры {картины}
фантик - обертка конфеты {обертка}
фанфара - инструмент род {инструмент}
фанфаронство - Поведение фанфарона {Поведение}
фарингоскопия - метод осмотра {метод}
фарисейство - Учение фарисеев {Учение}
фармакогнозия - Раздел фармации {Раздел}
фас - лица предмета {лица}
фашина - Пучок хвороста {Пучок}
фашист - Приверженец фашизма {Приверженец}
федералист - Сторонник федерализма {Сторонник}
фейерверкер - унтер-офицер артиллерии {унтер-офицер}
фельдмаршальство - Звание фельдмаршала {Звание}
фемида - Служители Фемиды# {Служители}
феминист - Сторонник феминизма {Сторонник}
феноменология - философии Гегеля {философии}
феодализация - Формирование феодализма {Формирование}
ферма - конструкция покрытия {конструкция}
ферма - хозяйство совхоза {хозяйство}
ферментация - процесс переработки {процесс}
фермерство - система хозяйства {система}
феррит - раствор углерода {раствор}
ферросплав - Сплав железа {Сплав}
ферт - буквы «ф {буквы}
фетишист - Последователь фетишизма {Последователь}
фехтование - Система приемов {Система}
фибриноген - белок плазмы {белок}
фигли-мигли - Проделки шутки {Проделки}
фидеист - Сторонник фидеизма {Сторонник}
фидер - Линия передачи {Линия}
физиогномика","физиономика - Искусство определения {Искусство}
физиотерапия - Раздел медицины {Раздел}
филин - птица отряда {птица}
филистерство - Поведение филистера {Поведение}
филлер - монета Венгрии {монета}
филофония - Коллекционирование звукозаписей {Коллекционирование}
филумения - Коллекционирование этикеток {Коллекционирование}
фильмокопия - Позитив кинофильма {Позитив}
фирман - указ султана {указ}
фирн - снег границы {снег}
фискальство - Поведение фискала {Поведение}
фитин - соединение фосфора {соединение}
фланг - сторона доски {сторона}
флаттер - Вибрация крыла {Вибрация}
флебит - Воспаление вены {Воспаление}
флексура - изгиб слоев {изгиб}
флористика - Раздел ботаники {Раздел}
флот - Совокупность судов {Совокупность}
флотатор - руды минерала {руды}
флотация - Метод обогащения {Метод}
флюоресценция - Свечение вещества {Свечение}
флюс - воспаление десны {воспаление}
фобия - состояние страха {состояние}
фокстерьер - Порода домашних {Порода}
фольклорность - Наличие элементов {Наличие}
фон - Шум помехи {Шум}
фонастения - Расстройство голоса {Расстройство}
фонема - Звук речи {Звук}
фонетика - строй языка {строй}
фонограмма - Запись звуков {Запись}
фонология - Раздел языкознания {Раздел}
фонтан - Струя воды {Струя}
форвард - Игрок нападения {Игрок}
форзац - лист бумаги {лист}
форинт - единица Венгрии {единица}
форманта - характеристика звука {характеристика}
формат - Размер книги {Размер}
формация - строение чего {строение}
формоизменение - Изменение формы {Изменение}
формула - определение чего {определение}
формуляр - список чиновников {список}
форштевень - оконечность судна {оконечность}
фот - Единица освещенности {Единица}
фотовспышка - освещение какого {освещение}
фотогравюра - Репродукция картины {Репродукция}
фотография - Способ получения {Способ}
фотокерамика - Получение изображений {Получение}
фотокопия - Копия какого {Копия}
фотолиз - Распад молекул {Распад}
фотомеханика - Совокупность процессов {Совокупность}
фотон - Частица света {Частица}
фотосфера - слой атмосферы {слой}
фотохроника - Хроника событий {Хроника}
фотоцинкография - способ изготовления {способ}
фрагмент - Отрывок сочинения {Отрывок}
фразеологизм - сочетание слов {сочетание}
фразеология - Совокупность приемов {Совокупность}
фракционер - Член какой {Член}
фракция - группа людей {группа}
франк - единица Франции {единица}
фратрия - Подразделение племени {Подразделение}
фриз - ткань типа {ткань}
фрондер - Участник фронды {Участник}
фронт - Строй войск {Строй}
фронтиспис - фасад здания {фасад}
фтизиатрия - Раздел медицины {Раздел}
фунт - мера веса {мера}
фургонщик - Возница фургона {Возница}
фурия - богинь мщения {богинь}
фурштат - Военный обоз {Военный}
фурьерист - Последователь фурьеризма {Последователь}
фут - Мера длины {Мера}
футурист - Последователь футуризма {Последователь}
фухтель - сторона клинка {сторона}
ха - буквы «х {буквы}
хаз - полоса куска {полоса}
хайло - отверстие печи {отверстие}
хамелеон - Животное отряда {Животное}
ханжество - набожность добродетельность {набожность}
харчевник - Содержатель харчевни {Содержатель}
хворост - ветви деревьев {ветви}
хер - буквы «х {буквы}
химизм - природа какого {природа}
химиотерапия - Лечение болезней {Лечение}
хинди - язык Индии {язык}
хиротония - посвящение лиц {посвящение}
хирургия - Раздел медицины {Раздел}
хитреца - доле хитрости {доле}
хитринка - доле хитрости {доле}
хитросплетение - переплетение каких {переплетение}
хладноломкость - Возрастание хрупкости {Возрастание}
хлебозакупки - Закупка хлеба {Закупка}
хлебопашество - Возделывание земли {Возделывание}
хлебопечение - Выпечка хлеба {Выпечка}
хлебопоставки - сдача хлеба {сдача}
хлебопродукты - Продукты обмолота {Продукты}
хлебосдача - Сдача хлеба {Сдача}
хлебоуборка - Уборка хлебов {Уборка}
хлопец - Подросток мальчик {Подросток}
хлопкоочистка - обработка хлопка {обработка}
хлопкопрядение - Процесс изготовления {Процесс}
хлопкосеяние - Разведение хлопчатника {Разведение}
хлопкоуборка - Уборка хлопка {Уборка}
хлопоты - Дела занятия {Дела}
хлориды - соединения хлора {соединения}
хлороз - Болезнь растений {Болезнь}
хлорофилл - пигмент растений {пигмент}
хлуп","хлупь - Кончик крестца {Кончик}
хлыстовство - Учение хлыстов {Учение}
хлыщ - человек фат {человек}
хлюст - подбор карт {подбор}
хлябь - глубина моря {глубина}
хлястик - полоса ткани {полоса}
хмельник - Заросли хмеля {Заросли}
хна - краска волос {краска}
хозяйство - Способ производства {Способ}
холера - заболевание человека {заболевание}
холод - температура воздуха {температура}
холодность - Отсутствие пылкости {Отсутствие}
холопство - Состояние холопа {Состояние}
холстинка - кусок холста {кусок}
холуй - слуги лакея {слуги}
хорда - Отрезок прямой {Отрезок}
хореография - Искусство композиции {Искусство}
хормейстер - Руководитель хора {Руководитель}
хоругвь - знамя войска {знамя}
хорьчонок - Детеныш хорька {Детеныш}
хохма - шутка что {шутка}
хохол - клок волос {клок}
храпак - храпака (шутл {храпака}
храповицкий - храповицкого (шутл {храповицкого}
хребет - Позвоночник человека {Позвоночник}
хрип - нечистого тона {нечистого}
хрипота - Наличие хрипа {Наличие}
христианин - Последователь христианства {Последователь}
христианство - религий мира {религий}
хромель - Сплав никеля {Сплав}
хромолитография - способ печатания {способ}
хромосомы - элементы ядра {элементы}
хромота - Неправильность походки {Неправильность}
хроника - Запись событий {Запись}
хроникер - Сотрудник газеты {Сотрудник}
хронология - Последовательность каких {Последовательность}
хронометраж - Метод изучения {Метод}
хрусталик - кусочек хрусталя {кусочек}
хрыч - человека старика {человека}
хрюканье - Крик свиньи {Крик}
хряк - Самец свиньи {Самец}
хрящ - ткань организма {ткань}
худо'ба - имущество (вещи {имущество}
хулиганство - Нарушение правил {Нарушение}
хунта - объединений союзов {объединений}
хурал - Наименование органов {Наименование}
хурма - дерево кустарника {дерево}
хуторянин - Владелец хутора {Владелец}
царевич - Сын царя {Сын}
царевна - Дочь царя {Дочь}
царение - Правление какого {Правление}
цареубийство - Убийство царя {Убийство}
цареубийца - Убийца царя {Убийца}
царь - Титул монарха {Титул}
цвет - Свойство тела {Свойство}
цветочница - Продавщица цветов {Продавщица}
цедра - слой кожуры {слой}
целеуказание - Указание места {Указание}
целость - состояние чего {состояние}
цементация - Закрепление грунтов {Закрепление}
цена - Стоимость какого {Стоимость}
ценз - перепись граждан {перепись}
цензорство - Должность обязанности {Должность}
цензура - должность цензора {должность}
ценник - Справочник цен {Справочник}
ценообразование - Процесс формирования {Процесс}
центнер - Единица веса {Единица}
центр - Точка пересечения {Точка}
централизм - Система управления {Система}
центрист - Сторонник центризма {Сторонник}
центурион - Начальник центурии {Начальник}
цепочка - цепь (см {цепь}
цепь - Ряд гор {Ряд}
церемониймейстер - придворных чинов {придворных}
церемония - порядок совершения {порядок}
церковница - Жена церковника {Жена}
церковь - организация духовенства {организация}
цесаревич - наименование наследника {наименование}
цесаревна - Жена цесаревича {Жена}
цесарка - Птица отряда {Птица}
цех - организация ремесленников {организация}
цианирование - Способ извлечения {Способ}
цианоз - цвет кожи {цвет}
цикл - Совокупность каких {Совокупность}
циклография - Метод изучения {Метод}
цинизм - Учение циников {Учение}
цинкография - Способ изготовления {Способ}
циркач - Артист цирка {Артист}
цитохимия - Раздел цитологии {Раздел}
цоканье - Особенность произношения {Особенность}
цыпленок - Птенец курицы {Птенец}
цэ - буквы «ц {буквы}
чабарня - Жилище чабана {Жилище}
чадра - покрывало женщин {покрывало}
чаепитие - Питье чая {Питье}
чаинка - кусочек листка {кусочек}
чайханщик - Содержатель чайханы {Содержатель}
чалма - кусок материи {кусок}
чапыги - Ручки плуга {Ручки}
чартизм - движение рабочих {движение}
час - Единица измерения {Единица}
частное - Результат деления {Результат}
частокол - Забор изгородь {Забор}
частотность - Показатель частоты {Показатель}
часть - Доля целого {Доля}
чахотка - истощения организма {истощения}
че - буквы «ч {буквы}
чебак - рыб плотвы {рыб}
челка - Прядь гривы {Прядь}
человеко-день - Единица учета {Единица}
человеко-час - Единица учета {Единица}
человекоубийство - Убийство человека {Убийство}
человекоубийца - Убийца человека {Убийца}
человечина - Мясо человека {Мясо}
чембур - повод уздечки {повод}
чемодан - коробки ящика {коробки}
чемпионство - Звание чемпиона {Звание}
червь - буквы «ч {буквы}
черед - порядок очередности {порядок}
череззерница - завязывание семян {завязывание}
черемушник - Заросли черемухи {Заросли}
черенок - Рукоятка какого {Рукоятка}
череп - Скелет головы {Скелет}
чернила - раствор какого {раствор}
черничество - Образ жизни {Образ}
черничина - ягода черники {ягода}
черничник - Заросли черники {Заросли}
чернокнижие - Знание приемов {Знание}
черносливина - ягода чернослива {ягода}
четверик - мера объема {мера}
четвертак - Четверть рубля {Четверть}
четырехлетие - Промежуток времени {Промежуток}
четырехсотлетие - Промежуток времени {Промежуток}
чечет - Самец чечетки {Самец}
чешуекрылые - насекомых бабочки {насекомых}
чинар","чинара - Дерево рода {Дерево}
чиновница - Жена чиновника {Жена}
чиновничество - Чиновники (см {Чиновники}
чиноначалие - Иерархия чинов {Иерархия}
чиренок - Птенец чирка {Птенец}
чирики - Башмаки туфли {Башмаки}
чичисбей - спутник женщины {спутник}
членик - Отдел тела {Отдел}
членовредительство - повреждение какого {повреждение}
чревосечение - операция вскрытия {операция}
чресла - Поясница бедра {Поясница}
чуб - Прядь волос {Прядь}
чувствилище - чувства впечатления {чувства}
чугун - Сплав железа {Сплав}
чудо - явление чего {явление}
чурбан - Обрубок дерева {Обрубок}
чутье - Способность человека {Способность}
чуфыканье - звуки «чуф {звуки}
ша - буквы «ш {буквы}
шаг - движение чего {движение}
шайка - Группа людей {Группа}
шаланда - судно типа {судно}
шаман - Служитель культа {Служитель}
шампанизация - Насыщение вина {Насыщение}
шарж - манера изображения {манера}
шаромыжничество - Образ действий {Образ}
шатун - Деталь машины {Деталь}
шах - нападение какой {нападение}
шах - Титул монарха {Титул}
швейцарцы - Население Швейцарии {Население}
шейх - Титул правителей {Титул}
шелкоткачество - Выработка тканей {Выработка}
шериф - звание мусульманина {звание}
шерпы - Народность Гималаев {Народность}
шерстинка - Волосок шерсти {Волосок}
шерстопрядение - Прядение шерсти {Прядение}
шерстоткачество - Выработка ткани {Выработка}
шерсть - покров млекопитающих {покров}
шестерик - мера (счета {мера}
шестидесятилетие - Промежуток времени {Промежуток}
шестидневка - Промежуток времени {Промежуток}
шестилетие - Промежуток времени {Промежуток}
шестипалость - порок развития {порок}
шестисотлетие - Промежуток времени {Промежуток}
шивера - участок русла {участок}
шинкарство - Содержание шинка {Содержание}
ширина - Протяжение чего {Протяжение}
ширинка - полотнище ткани {полотнище}
шихта - Смесь материалов {Смесь}
шиш - верхушка чего {верхушка}
шкалик - мера объема {мера}
шкварки - кусочки сала {кусочки}
шкирка - шкирку меня {шкирку}
школьник - Ученик школы {Ученик}
шкура - покров тела {покров}
шлемофон - Шлем летчиков {Шлем}
шлиф - пластинка минерала {пластинка}
шлих - Остаток частиц {Остаток}
шлык - убор русских {убор}
шляхта - ряде стран {ряде}
шмуцтитул - Лист бумаги {Лист}
шов - Место соединения {Место}
шовинист - Приверженец шовинизма {Приверженец}
шок - жизни человека {жизни}
шоколадка - плитка шоколада {плитка}
шофер - Водитель автомобиля {Водитель}
шпаргалка - Листок бумаги {Листок}
шпатель - Инструмент живописца {Инструмент}
шпионство - Деятельность шпиона {Деятельность}
шпицрутены - прутья палки {прутья}
шпроты - рыба (салаки {рыба}
штаб - Орган управления {Орган}
штаб-квартира - Место расположения {Место}
штабель - ряд чего {ряд}
штамм - культура микроорганизмов {культура}
штамповка - Изготовление изделия {Изготовление}
штат - состав лиц {состав}
штатгальтер - правителей областей {правителей}
штерт - отрезок линя {отрезок}
штоф - мера объема {мера}
штрейкбрехерство - Участие штрейкбрехеров {Участие}
штука - предмет какое {предмет}
штурм - атака крепости {атака}
штуф - Кусок породы {Кусок}
шумовик - Работник театра {Работник}
шурин - Брат жены {Брат}
шуры-муры - дела похождения {дела}
шутовство - Занятие шута {Занятие}
ща - буквы «щ {буквы}
щегленок - Птенец щегла {Птенец}
щегловка - Самка щегла {Самка}
щелкопер - писателя журналиста {писателя}
щелочность - Степень насыщения {Степень}
щелчок - удар выстрела {удар}
щенок - Детеныш собаки {Детеныш}
щепка - пластинка дерева {пластинка}
щиколотка - бокам ноги {бокам}
щуп - инструментов служащих {инструментов}
щупальца - выросты тела {выросты}
щур - предок родоначальник {предок}
щуренок - Детеныш щуки {Детеныш}
эволюция - Процесс изменения {Процесс}
эвристика - Совокупность приемов {Совокупность}
эдикт - программа деятельности {программа}
эжекция - Процесс смещения {Процесс}
эквадорцы - Население Эквадора {Население}
экзарх - Глава жрецов {Глава}
экзема - заболевание кожи {заболевание}
экзотика - особенности (природы {особенности}
экивоки - Намеки недоговоренности {Намеки}
экономизация - Осуществление экономии {Осуществление}
экосез - танец типа {танец}
экранизация - Создание фильма {Создание}
экспансионизм - политика экспансии {политика}
экспансионист - Сторонник экспансионизма {Сторонник}
экспансия - Расширение сферы {Расширение}
эксперимент - Воспроизведение какого {Воспроизведение}
экспериментаторство - Проведение экспериментов {Проведение}
эксплуатация - Присвоение результатов {Присвоение}
экспозе - изложение какого {изложение}
экспорт - Вывоз товаров {Вывоз}
экспрессионист - Последователь экспрессионизма {Последователь}
экстаз - степень воодушевления {степень}
экстернат - порядок сдачи {порядок}
экстерьер - телосложение животных {телосложение}
экстрагирование - Разделение смеси {Разделение}
экстраполяция - Распространение выводов {Распространение}
экстремист - Сторонник экстремизма {Сторонник}
эксцесс - проявление чего {проявление}
электричество - Совокупность явлений {Совокупность}
электродинамика - Раздел физики {Раздел}
электродоение - Доение коров {Доение}
электрокардиограмма - изображение работы {изображение}
электрокардиография - Метод исследования {Метод}
электролиния - Провод (провода {Провод}
электрометаллургия - Область металлургии {Область}
электрон - частица вещества {частица}
электрон - Сплав алюминия {Сплав}
электронография - Метод изучения {Метод}
электропривод - Совокупность устройств {Совокупность}
электропроводность - Способность какого {Способность}
электропрогрев - Прогревание чего {Прогревание}
электроразведка - метод разведки {метод}
электросварка - Сварка металлов {Сварка}
электросеть - Совокупность устройств {Совокупность}
электросистема - Совокупность электростанций {Совокупность}
электростатика - Раздел теории {Раздел}
электротермия - Отрасль электротехники {Отрасль}
электротехника - Отрасль науки {Отрасль}
электрофизиология - Раздел физиологии {Раздел}
электроэнергетика - область энергетики {область}
элита - экземпляры сорта {экземпляры}
эллинизм - Эпоха расцвета {Эпоха}
эль - буквы «л {буквы}
эльзевир - библиофилами книг {библиофилами}
элювий - Продукты выветривания {Продукты}
эм - буквы «м {буквы}
эмаль - масса изделия {масса}
эмболия - Закупорка сосуда {Закупорка}
эмбрион - Организм животного {Организм}
эмир - титул военачальника {титул}
эмиттер - Излучатель электрод {Излучатель}
эмка - автомобиль марки {автомобиль}
эмпирик - Последователь эмпиризма {Последователь}
эмпирика - Сведения знания {Сведения}
эмпириокритик - Последователь эмпириокритицизма {Последователь}
эмтээсовец - Работник МТС {Работник}
эмульгирование - Образование эмульсии {Образование}
эмфизема - скопление воздуха {скопление}
эн - буквы «н {буквы}
эндокард - оболочка сердца {оболочка}
эндокардит - Воспаление эндокарда {Воспаление}
энергетика - Область хозяйства {Область}
энергия - мера движения {мера}
энерговооруженность - Количество энергии {Количество}
энергомашиностроение - Отрасль промышленности {Отрасль}
энциклика - Послание папы {Послание}
эпейрофорез - перемещение материков {перемещение}
эпигон - последователь какого {последователь}
эпигонство - следование какому {следование}
эпиграмматист - Автор эпиграмм {Автор}
эпидемиология - Раздел медицины {Раздел}
эпидемия - распространение какой {распространение}
эпидермис - слой кожи {слой}
эпидермофития - заболевание кожи {заболевание}
эпизоотия - распространение какой {распространение}
эпикард - оболочка сердца {оболочка}
эпикардит - Воспаление эпикарда {Воспаление}
эпикриз - истории болезни {истории}
эпикуреец - Последователь эпикуреизма {Последователь}
эпистола - Жанр литературы {Жанр}
эпителий - Ткань человека {Ткань}
эполеты - погоны офицеров {погоны}
эпопея - цикл сказаний {цикл}
эпоха - период явлений {период}
эр - буквы «р {буквы}
эрг - Единица работы {Единица}
эргономика - Отрасль знания {Отрасль}
эрдельтерьер - Порода собак {Порода}
эре - монета Швеции {монета}
эрзац - заменитель чего {заменитель}
эрзя - группа мордвы {группа}
эринии - богини мщения {богини}
эритема - Покраснение кожи {Покраснение}
эрозия - Процесс разрушения {Процесс}
эрстед - Единица напряженности {Единица}
эрцгерцог - Титул принцев {Титул}
эрцгерцогство - Владения эрцгерцога {Владения}
эскадра - соединение судов {соединение}
эскиз - набросок рисунка {набросок}
эскудо - монета Португалии {монета}
эссенция - раствор какого {раствор}
эстезиология - Раздел анатомии {Раздел}
эстет - Поклонник искусства {Поклонник}
эстетизация - Придание чему {Придание}
эстрагон - растение рода {растение}
эстрадник - Артист эстрады {Артист}
этажность - Количество этажей {Количество}
этикет - порядок поведения {порядок}
этимологизация - Установление этимологии {Установление}
этимология - Раздел языкознания {Раздел}
этиология - Раздел медицины {Раздел}
этногенез - Происхождение народа {Происхождение}
этногеография - Раздел этнографии {Раздел}
этнонимика - Раздел ономастики {Раздел}
эф - буквы «ф {буквы}
эфедрин - Алкалоид эфедры {Алкалоид}
эфир - слой воздуха {слой}
эффект - впечатление каких {впечатление}
эффузия - Излияние лавы {Излияние}
эхо - Отражение звука {Отражение}
юань - единица Китая {единица}
юбилей - Годовщина какого {Годовщина}
юг - стран государства {стран}
югославы - Население Югославии {Население}
юнкерство - Юнкеры (см {Юнкеры}
юность - Период жизни {Период}
юриспруденция - Совокупность наук {Совокупность}
юродство - Состояние невменяемости {Состояние}
юрт - станицы хутора {станицы}
юрта - жилище кочевников {жилище}
ябедничество - Занятие ябедника {Занятие}
яблоко - Плод яблони {Плод}
ягельник - Заросли ягеля {Заросли}
ягненок - Детеныш овцы {Детеныш}
языкотворчество - Процесс создания {Процесс}
язычник - Последователь язычества {Последователь}
яйла - пастбищ Крыма {пастбищ}
яйцерождение - Способ воспроизведения {Способ}
яйцо - клетка птиц {клетка}
якобинство - Образ мыслей {Образ}
яловость - отсутствие приплода {отсутствие}
ямщина - Занятие ямшика {Занятие}
янки - Прозвище американцев {Прозвище}
японистика - Совокупность наук {Совокупность}
яр - берег реки {берег}
ярд - Единица длины {Единица}
ярмарка - время года {время}
ярус - рядов чего {рядов}
ясак - народы Поволжья {народы}
ястребенок - Птенец ястреба {Птенец}
ястык - Икра осетровых {Икра}
