аборт - прекращение беременности {прекращение}
абревиатура","абревиация - сокращение слов {сокращение}
абрек - эпоху завоевания {эпоху}
абрикос - плод дерева {плод}
абсолютист - Сторонник абсолютизма {Сторонник}
абстракция - отделение каких {отделение}
абсцисса - отрезок линии {отрезок}
абулия - Ослабление воли {Ослабление}
авангард - Отряд войска {Отряд}
авантюрист - Искатель приключений {Искатель}
авария - Повреждение судна {Повреждение}
автаркия - философии стоиков {философии}
автобаза - Место стоянки {Место}
автограф - рукопись автора {рукопись}
автономист - Сторонник автономии {Сторонник}
автор - Творец чего {Творец}
авторство - Принадлежность произведения {Принадлежность}
автотипия - способов печатания {способов}
агитка - средство напр {средство}
агитпроп - Отдел агитации {Отдел}
агония - вспышки жизни {вспышки}
агрессор - Виновник агрессии {Виновник}
адажио - темпе исполнения {темпе}
адвокатура - Профессия адвоката {Профессия}
адмиралтейство - Место постройки {Место}
адмиральша - Жена адмирала {Жена}
азиат - Уроженец Азии {Уроженец}
академик - Член академии {Член}
академист - Сторонник академизма {Сторонник}
академия - учреждение нек {учреждение}
аккомодация","акомодация - Приноровление глаза {Приноровление}
акмеист - Последователь акмеизма {Последователь}
актеатр - театр См {театр}
актёр - исполнитель ролей {исполнитель}
актёрка - Актриса (простореч {Актриса}
актёрство - Занятие актера {Занятие}
акустика - Отдел физики {Отдел}
акушерство","акушёрство - Отдел медицины {Отдел}
акцепт - Согласие кого {Согласие}
акционер - Владелец акций {Владелец}
алгебра - Отдел математики {Отдел}
алиби - Отсутствие обвиняемого {Отсутствие}
аллегро - темпе исполнения {темпе}
аллилуйщина","алилуйщина - Поведение аллилуйщика {Поведение}
аллопатия - система лечения {система}
аллюр - Способ хода {Способ}
алфавит - порядок букв {порядок}
альбинизм - белизна кожи {белизна}
альтернация - чередование звуков {чередование}
амальгама - Соединение какого {Соединение}
американец - Уроженец Америки {Уроженец}
аминь - слово молитв {слово}
аммоний - Соединение азота {Соединение}
амортизация - Прекращение действия {Прекращение}
ампер - Единица измерения {Единица}
амплитуда - Разность пределов {Разность}
амплуа - Характер ролей {Характер}
анабаптизм - Учение анабаптистов {Учение}
анаграмма - Перестановка букв {Перестановка}
анализ - Метод исследования {Метод}
анархист - Сторонник анархизма {Сторонник}
анархосиндикалист - Сторонник анархосиндикализма {Сторонник}
анахронизм - приурочение события {приурочение}
ангажемент - Приглашение артистов {Приглашение}
ангина - Воспаление горла {Воспаление}
англофильство - Образ мыслей {Образ}
англофобство - Образ мыслей {Образ}
анданте - темпе исполнения {темпе}
анилин - жидкость продукт {жидкость}
анкер - Регулятор маятника {Регулятор}
анкета - Собирание сведений {Собирание}
аннексия - присоединение страны {присоединение}
аннотация - изложение содержания {изложение}
аноним - Автор сочинения {Автор}
антимилитарист - Сторонник антимилитаризма {Сторонник}
антипатия - Чувство нерасположения {Чувство}
антисемитизм - Преследование евреев {Преследование}
антисептика - Обеззараживание ран {Обеззараживание}
антресоли - полуэтаж квартиры {полуэтаж}
антропометрия - Отрасль науки {Отрасль}
антропософ - Последователь антропософии {Последователь}
анфилада - ряд комнат {ряд}
апологет - апологией кого {апологией}
апологетика - Отрасль богословия {Отрасль}
апофеоз - обряд воздавания {обряд}
аппендицит","апендицит - Воспаление аппендикса {Воспаление}
аппликатура","апликатура - Способ расположения {Способ}
аппликация","апликация - Изготовление картины {Изготовление}
аппретура","апретура - отделка тканей {отделка}
аптекарша - Жена аптекаря {Жена}
аптекарь - Содержатель аптеки {Содержатель}
ар - мера поверхности {мера}
арийцы - групп индоевропейцев {групп}
аркада - Ряд арок {Ряд}
арматура - Вооружение (устар {Вооружение}
армия - войска государства {войска}
арпеджио - способе исполнения {способе}
арсенал - Склад оружия {Склад}
артель - Объединение группы {Объединение}
артельщик - Член артели {Член}
артикуляция - Работа органов {Работа}
артист - исполнением произведений {исполнением}
артрит - Болезнь суставов {Болезнь}
архиерей - епископа митрополита {епископа}
архитектоника - сочетание частей {сочетание}
аршин - мера длины {мера}
асимметрия","ассимметрия - Отсутствие симметрии {Отсутствие}
аскетизм - степень воздержания {степень}
аспект - Точка зрения {Точка}
астения - Слабость организма {Слабость}
астигматизм - Недостаток зрения {Недостаток}
астма - Приступы удушья {Приступы}
астраханка - селедки дыни {селедки}
астрофизика - Отдел астрономии {Отдел}
атом - частица материи {частица}
атомность - Способность атома {Способность}
атташе - Сотрудник посольства {Сотрудник}
аттрибут","атрибут - признак предмета {признак}
аукцион - Продажа какого {Продажа}
ауспиции - Предзнаменования обстоятельства {Предзнаменования}
афазия - Утрата способности {Утрата}
аффект","афект - Состояние запальчивости {Состояние}
ахроматизм - Свойство систем {Свойство}
аэронавигация - Дисциплина к {Дисциплина}
аэропочта - почта См {почта}
баба","бой-баба","баба-яга - устах «господ {устах}
бабка - сустав ноги {сустав}
бабуся - Ласкат к {Ласкат}
бабушка - Мать отца {Мать}
бабьё - Бабы (см {Бабы}
бадяга - губка (бот {губка}
балаганщик - Хозяин балагана {Хозяин}
баламут - смутьян человек {смутьян}
балерина - Артистка балета {Артистка}
балетмейстер - Постановщик танцев {Постановщик}
балясина - столбик перил {столбик}
банщик - Содержатель бань {Содержатель}
баптизм - Учение баптистов {Учение}
баранина - Мясо барана {Мясо}
барбос - кличка дворовых {кличка}
барок","барокко - стиль конца {стиль}
барочник - Хозяин барки {Хозяин}
барство - Сословие дворян {Сословие}
барышничество - Промысел барышника {Промысел}
барьер - Забор перегородка {Забор}
баснописец - Автор басен {Автор}
баснословие - Мифология истории {Мифология}
басурман - обозначение магометанина {обозначение}
батенька - Ласкат к {Ласкат}
батрачество - Занятие батрака {Занятие}
батрачком - Сокращение слов {Сокращение}
бахчевник - Владелец бахчи {Владелец}
башмак - обувь (истор {обувь}
бедняжка - Ласкат к {Ласкат}
безбожие - Отрицание бога {Отрицание}
безветрие - Спокойствие воздуха {Спокойствие}
безвкусица - Проявление безвкусия {Проявление}
безводье - Отсутствие воды {Отсутствие}
бездетность - Неимение детей {Неимение}
беззаконие - Отсутствие законности {Отсутствие}
безличие","безличность - Отсутствие своеобразия {Отсутствие}
безлюдье - Отсутствие людей {Отсутствие}
безначалие - Отсутствие власти {Отсутствие}
безопасность - Отсутствие опасности {Отсутствие}
безработица - Отсутствие спроса {Отсутствие}
безрукавка - одежды куртки {одежды}
безрыбье - Отсутствие рыбы {Отсутствие}
бек - Сокращение слова {Сокращение}
беловик - рукопись (см {рукопись}
белок - оболочка глаза {оболочка}
белокровие - Заболевание крови {Заболевание}
белужина - Мясо белуги {Мясо}
бель - Белизна (обл {Белизна}
бенефициант - Работник театра {Работник}
бенуар - ярус лож {ярус}
берег - Край земли {Край}
беременность - ношение плода {ношение}
бери-бери - Болезнь обмена {Болезнь}
берковец - Мера веса {Мера}
берлога - логовище медведя {логовище}
берёзонька - Ласкат к {Ласкат}
берёста","береста - слой коры {слой}
беседчик - Руководитель беседы {Руководитель}
бескорыстие - Отсутствие заботы {Отсутствие}
беспорядок - Отсутствие порядка {Отсутствие}
беспредметник - Сторонник направления {Сторонник}
бессмыслица - набор слов {набор}
бессонница - отсутствие сна {отсутствие}
бесстрастие - невозмутимость страстности {невозмутимость}
бесстрашие - Отсутствие робости {Отсутствие}
бестиализм - Преобладание животных {Преобладание}
бесчестье - Поругание чести {Поругание}
бесчинство - Нарушение порядка {Нарушение}
бечевник - Полоса берега {Полоса}
библиофил - Любитель книг {Любитель}
библия - Книги т {Книги}
бивак - Стоянка войск {Стоянка}
биограф - Составитель биографии {Составитель}
бирюк - Волк (обл {Волк}
бисерина - Зерно бисера {Зерно}
бицепс - мышц плеча {мышц}
благодарность - Чувство признательности {Чувство}
благодать - Полнота благ {Полнота}
благодушие - Мягкость характера {Мягкость}
благополучие - течение жизни {течение}
благоприобретение - Приобретение чего {Приобретение}
блаженство - степень счастья {степень}
блат - Преступление воровство {Преступление}
блеяние - Крик овцы {Крик}
близорукость - Недостаток зрения {Недостаток}
блокада - Обложение неприятеля {Обложение}
бобок - зерно боба {зерно}
бобровина - Мясо бобра {Мясо}
бобрёнок - Детеныш бобра {Детеныш}
бобылиха - Жена бобыля {Жена}
бобёр - Мех бобра {Мех}
богатырство - Совокупность свойств {Совокупность}
богатырь - Герой русских {Герой}
богоносец - идею бога {идею}
боженька - Ласкат к {Ласкат}
бой-скаутизм - Движение бой {Движение}
бойкотист - Участник какого {Участник}
бок - сторона предмета {сторона}
боксёр - Профессионал бокса {Профессионал}
болван - Обрубок дерева {Обрубок}
болезнь - Расстройство здоровья {Расстройство}
болеро - танец (муз {танец}
болтушка - Ласкат к {Ласкат}
большевик - Член ВКП {Член}
бом-брам-стеньга - стеньга См {стеньга}
бондариха - Жена бондаря {Жена}
бордель - Дом терпимости {Дом}
бордеро - Опись документов {Опись}
бордюр - Полоса материи {Полоса}
борзописание - творчество борзописца {творчество}
борзятник - Любитель охоты {Любитель}
боров - Самец свиньи {Самец}
борт - стенка бильярда {стенка}
бочарня - Мастерская бочара {Мастерская}
бош - кличка немцев {кличка}
боярыня - Жена боярина {Жена}
боярышня - дочь боярина {дочь}
боёк - Кончик курка {Кончик}
брак - дефект продукция {дефект}
брак - Сожительство супругов {Сожительство}
бракераж - освидетельствование товаров {освидетельствование}
браковщик - Рабочий к {Рабочий}
браконьерство - Занятие браконьера {Занятие}
бракосочетание - Обряд вступления {Обряд}
брам-стеньга - стеньга см {стеньга}
брамин - Жрец человек {Жрец}
брандахлыст - напиток пища {напиток}
брандер - появления миноносок {появления}
брасс - стиль плавания {стиль}
братан - брат брата {брат}
братишка - брат (простореч {брат}
братчик - Член братства {Член}
брахманизм - Религия индусов {Религия}
бред - речь больного {речь}
бригадирша - Жена бригадира {Жена}
бригадник - Участник бригады {Участник}
бровь - полоска волос {полоска}
брод - место реки {место}
бронесилы - Военные орудия {Военные}
бронза - Сплав меди {Сплав}
брыжейка - Складка брюшины {Складка}
брызги - Капли жидкости {Капли}
брюхоногие - классов моллюсков {классов}
брёх - Вранье сплетни {Вранье}
буддист - Последователь буддизма {Последователь}
будни - день м {день}
бузинник - Кусты бузины {Кусты}
бузотёрство - Поведение бузотера {Поведение}
буйволица - Самка буйвола {Самка}
буква - Знак азбуки {Знак}
букет - пучок цветов {пучок}
букли - завитки волос {завитки}
булочник - Владелец булочной {Владелец}
бумажонка - клочок бумаги {клочок}
бундовец - Член бунда {Член}
бунтарь - Участник бунта {Участник}
бура - соль натрия {соль}
бурак - свекла (обл {свекла}
буржуй - обозначение буржуа {обозначение}
бурлачество - Профессия бурлака {Профессия}
бурсак - Воспитанник бурсы {Воспитанник}
бурундук - грызун шкурки {грызун}
бусина - зерно бус {зерно}
бутерброд - Ломтик хлеба {Ломтик}
бушель - Мера емкости {Мера}
бык - Самец коровы {Самец}
былинка - Стебелек травы {Стебелек}
быт - уклад жизни {уклад}
бытьё - Образ жизни {Образ}
бьеф - Участок реки {Участок}
бюджет - роспись доходов {роспись}
бюллетень - сообщение (напр {сообщение}
бюрократия - Система управления {Система}
бюст - изображение человека {изображение}
ваия","вайя - ветвь папоротника {ветвь}
вакцинация - прививка вакцины {прививка}
валерьянка - капли см {капли}
валок - вал (см {вал}
вальдшнеп - птица отряда {птица}
ванилин - Суррогат ванили {Суррогат}
ваниль - растение (бот {растение}
варакушка - птица рода {птица}
варвар - Представитель народа {Представитель}
варваризм - чистоту речи {чистоту}
вахмистр - Унтер-офицер кавалерии {Унтер-офицер}
вдовство - Состояние вдовца {Состояние}
ведомство - Система учреждений {Система}
великодушие - Свойство характера {Свойство}
венец - убор род {убор}
веник - Связка веток {Связка}
венчание - Обряд возведения {Обряд}
венчик - Лепестки цветка {Лепестки}
вера - Состояние сознания {Состояние}
верблюдица - Самка верблюда {Самка}
верблюжина - Мясо верблюда {Мясо}
верблюжонок - Детеныш верблюда {Детеныш}
верниссаж - просмотр выставки {просмотр}
вероисповедание - -н религии {-н}
веротерпимость - Признание права {Признание}
вероучитель - Истолкователь вероучения {Истолкователь}
вероятие - Правдоподобие возможности {Правдоподобие}
версия - изложений толкований {изложений}
верста - мера длины {мера}
вертячка - Болезнь животных {Болезнь}
верфь - Совокупность сооружений {Совокупность}
верховье - течение реки {течение}
верхотура - Верх чего {Верх}
вершник - Верховой (см {Верховой}
вершок - мера длины {мера}
верёвочка - Ласкат к {Ласкат}
вес - Тяготение тела {Тяготение}
весна - Время года {Время}
весточка - Ласкат к {Ласкат}
ветер - Движение потока {Движение}
ветеран - воин солдат {воин}
ветка - Отросток кустарника {Отросток}
вехист","веховец - Участник сборника {Участник}
вече - Собрание горожан {Собрание}
вечеринка - собрание молодежи {собрание}
взвод - подразделение роты {подразделение}
взнос - Внесение платы {Внесение}
взяток - Добыча пчелы {Добыча}
вибрация - движение какого {движение}
визига - пищу сухожилия {пищу}
визит - посещение знакомых {посещение}
виконтесса - Жена виконта {Жена}
виктория - земляники т {земляники}
вилорог - Порода антилоп {Порода}
винтёр - Любитель игры {Любитель}
винчестер - Ружье род {Ружье}
вираж - Место поворота {Место}
вираж - Раствор золота {Раствор}
виршеплёт - сочинитель стихов {сочинитель}
виталист - Сторонник витализма {Сторонник}
витийство - Искусство витии {Искусство}
вихрун - голубь рыжего {голубь}
вихрь - движение ветра {движение}
владение - Обладание чем {Обладание}
внимательность - Степень внимания {Степень}
внук - Сын дочери {Сын}
внучка - Дочь сына {Дочь}
внушение - Воздействие кого {Воздействие}
вовлечься - Сов к {Сов}
водевилист - Автор водевилей {Автор}
водоизмещение - Количество воды {Количество}
водолечение - метод лечения {метод}
водоосвящение - Обряд т {Обряд}
водопад - поток воды {поток}
водополье - разлив рек {разлив}
водопровод - Система труб {Система}
водосвятие - Обряд т {Обряд}
водоскат - Падение воды {Падение}
водоём - Вместилище воды {Вместилище}
воевода - Начальник города {Начальник}
военачальник - Предводитель войск {Предводитель}
военкомат - Сокращение слов {Сокращение}
военмор - Военнослужащий флота {Военнослужащий}
военспец - Сокращение слов {Сокращение}
вождь - Предводитель войска {Предводитель}
воздействие - Система действий {Система}
воззрение - Точка зрения {Точка}
возлияние - Принесение вина {Принесение}
возрождение - Эпоха расцвета {Эпоха}
воин - Военный солдат {Военный}
вой - крик (волка {крик}
волгарь - Уроженец Поволжья {Уроженец}
волеизъявление - Обнаружение желания {Обнаружение}
воловина - Мясо вола {Мясо}
волок - Пространство земли {Пространство}
волокитство - Волокита (см {Волокита}
волосатик - червяк (зоол {червяк}
волосатость - Степень покрытия {Степень}
волчанка - туберкулез кожи {туберкулез}
волчец - трав (бот {трав}
волчица - Самка волка {Самка}
волчонок - Детеныш волка {Детеныш}
волшебник - Колдун чародей {Колдун}
вольт - Единица измерения {Единица}
вольтаж - Степень напряжения {Степень}
вольтерьянец - Последователь учения {Последователь}
волюнтаризм - Направление психологии {Направление}
волюнтарист - Последователь волюнтаризма {Последователь}
волюта - Завиток капители {Завиток}
вопросник - Перечень вопросов {Перечень}
воробка - Самка воробья {Самка}
воробьиха - Самка воробья {Самка}
воронёнок - Птенец ворона {Птенец}
ворот - Край одежды {Край}
ворсинка - Волосок ворса {Волосок}
воскобой - Извлечение воска {Извлечение}
воскресенье - дней недели {дней}
восприемник - обряде крещения {обряде}
восприятие - Узнавание предметов {Узнавание}
восток - стран Азии {стран}
восторг - подъем чувств {подъем}
восточник - Студент факультета {Студент}
вояжёр - Путешественник (шутл {Путешественник}
впрячься - Сов к {Сов}
время - Длительность бытия {Длительность}
времяисчисление - Система календаря {Система}
времяпрепровождение","времяпровождение - Использование времени {Использование}
всевобуч - Сокращение слов {Сокращение}
вселенная - Система мироздания {Система}
всполье - Окраина поля {Окраина}
вторник - дней недели {дней}
второзаконие - книг Моисея {книг}
втузовец - Студент втуза {Студент}
втузовка - Студентка втуза {Студентка}
вузовец - Студент вуза {Студент}
вузовка - Студентка вуза {Студентка}
вулканизация - Обработка каучука {Обработка}
вшивость - Обилие вшей {Обилие}
выборзок - Помесь борзой {Помесь}
выборность - Порядок замещения {Порядок}
выворот - положение какого {положение}
выговор - Произношение звуков {Произношение}
выдвиженчество - Система назначения {Система}
выдел - Выделение кому {Выделение}
выдрёнок - Детеныш выдры {Детеныш}
выдых - Выталкивание воздуха {Выталкивание}
выжлята - Щенята выжлеца {Щенята}
выкидыш - прекращение беременности {прекращение}
вылазка - Выход части {Выход}
вымысел - Фантазия что {Фантазия}
выползок - Шкура насекомого {Шкура}
выпрячься - Сов к {Сов}
вырождение - Ухудшение строения {Ухудшение}
высевок - полоска засева {полоска}
высечься - Сов к {Сов}
выстрел - Выпуск заряда {Выпуск}
выходка - Обработка ситца {Обработка}
вычерпка - процессов приготовления {процессов}
вычислитель - Сотрудник какого {Сотрудник}
вьюн - рыба миноги {рыба}
вьюновые - Порода рыб {Порода}
вьюрок - птичка отряда {птичка}
вязанка - Принадлежность одежды {Принадлежность}
габитус - облик человека {облик}
гавот - танец (муз {танец}
газетчик - продавец газет {продавец}
гайдук - лакей времен {лакей}
галифе - покрое брюк {покрое}
галчонок - Птенец галки {Птенец}
гальванопластика - Способ покрывания {Способ}
гам - гул голосов {гул}
гамма - ряд каких {ряд}
гангрена - Омертвение тканей {Омертвение}
гармонизация - Построение аккордов {Построение}
гарпия - древнегреч мифологии {древнегреч}
гарт - Сплав свинца {Сплав}
ге - буквы «г {буквы}
гегельянец - Последователь философии {Последователь}
гелиогравюра - воспроизведения рисунков {воспроизведения}
гемоглобин - вещество крови {вещество}
геморрой","геморой - Болезнь застоя {Болезнь}
генеалогия - история рода {история}
генерал-губернатор - Начальник края {Начальник}
генералитет - чины армии {чины}
генеральша - Жена генерала {Жена}
генетика - Отрасль биологии {Отрасль}
генштаб - штаб См {штаб}
геометрия - Отдел математики {Отдел}
геофизика - Совокупность дисциплин {Совокупность}
геральдика - Описание гербов {Описание}
германофильство - Образ мыслей {Образ}
германофобство - Образ мыслей {Образ}
германцы - Подданные Германии {Подданные}
гетманство - Власть гетмана {Власть}
гидра - Древнегреч мифологии {Древнегреч}
гидрография - Отдел гидрологии {Отдел}
гидролиз - разложение нек {разложение}
гидрометрия - Отдел гидрологии {Отдел}
гидростатика - Отдел физики {Отдел}
гидротехника - Отрасль техники {Отрасль}
гидроторф - способ торфа {способ}
гильза - патрон папиросы {патрон}
гимназист - Ученик гимназии {Ученик}
гиперборейцы - древнегреч мифологии {древнегреч}
гипертрофия - увеличение какого {увеличение}
гипсометрия - Отдел геодезии {Отдел}
главкизм - Система управления {Система}
главком - Сокращение слова {Сокращение}
глаголь - буквы «г {буквы}
глаз - Орган зрения {Орган}
глазомер - Измерения расстояния {Измерения}
гланды - Нёбные миндалины {Нёбные}
глаукома - Болезнь глаз {Болезнь}
глинозём - Окись алюминия {Окись}
глосса - Заметка переписчика {Заметка}
глоток - Движение мускулов {Движение}
глухонемота - Отсутствие слуха {Отсутствие}
гнида - Яичко вши {Яичко}
гниение - Процесс разрушения {Процесс}
гноекровие - Заболевание организма {Заболевание}
говядина - Мясо быка {Мясо}
гогот - Крик гусей {Крик}
год - Единица летосчисления {Единица}
головастик - Личинка лягушки {Личинка}
головоногие - Класс моллюсков {Класс}
голод - ощущение потребности {ощущение}
голосоведение - Искусство сочетания {Искусство}
голубка - Самка голубя {Самка}
голубушка - оттенком ласки {оттенком}
голубчик - оттенком ласки {оттенком}
голубятина - Мясо голубя {Мясо}
голубятник - Любитель голубей {Любитель}
голубёнок - Птенец голубя {Птенец}
голыш - человек (обл {человек}
гомон - шум множества {шум}
гомункул","гомункулус - человек к {человек}
гонт - стороны дранки {стороны}
горбушка - кусок ковриги {кусок}
гордец - знач человек {знач}
гордыня - гордость (см {гордость}
горесть - Чувство печали {Чувство}
горец - Обитатель гор {Обитатель}
горимость - Количество пожаров {Количество}
городничество - Должность городничего {Должность}
городничий - Начальник города {Начальник}
городничиха - Жена городничего {Жена}
горожанин - Житель города {Житель}
гороскоп - предсказание судьбы {предсказание}
горошина - Зерно гороха {Зерно}
горькая - нек сортов {нек}
господь - наименований бога {наименований}
гость - Посетитель ресторана {Посетитель}
градиент - Изменение какой {Изменение}
градина - Крупинка града {Крупинка}
градобитие - Истребление посевов {Истребление}
градус - Единица измерения {Единица}
гражданин - Подданный какого {Подданный}
гражданство - положение гражданина {положение}
грамм","грамм-атом","грамм-молекула - единица веса {единица}
грамматик - Автор грамматики {Автор}
гран - Единица мер {Единица}
граница - Линия раздела {Линия}
грануляция - зарастание раны {зарастание}
графика - искусство (искус {искусство}
графство - Звание графа {Звание}
гренки - ломтики хлеба {ломтики}
грим - Раскраска лица {Раскраска}
гробокопательство - Занятие гробокопателя {Занятие}
гроздь - Кисть ягод {Кисть}
громовержец - Метатель грома {Метатель}
гросмейстер - Глава ордена {Глава}
гроссбух","гросбух - книга (см {книга}
гротеск - Произведение искусства {Произведение}
груда - куча каких {куча}
грузопоток - Движение грузов {Движение}
группком","групком - Сокращение слов {Сокращение}
групповод - Руководитель группы {Руководитель}
груша - плод изделий {плод}
грушовка - наливка яблок {наливка}
грюндерство - Занятие грюндера {Занятие}
губернатор - Начальник штата {Начальник}
губернаторша - Жена губернатора {Жена}
губка - животное типа {животное}
гузка - Задок птицы {Задок}
гуманизм - движение эпохи {движение}
гуманист - Представитель гуманизма {Представитель}
гуммоз - Болезнь растений {Болезнь}
гурт - Стадо скота {Стадо}
гурьба - кучка людей {кучка}
гусеница - Личинка бабочки {Личинка}
гусыня - Самка гуся {Самка}
гусятина - Мясо гуся {Мясо}
гусёнок - Птенец гуся {Птенец}
гяур - магометан иноверца {магометан}
дактилоскопия - Метод установления {Метод}
дальнозоркость - Недостаток зрения {Недостаток}
дальтон-план - метод обучения {метод}
дальтонизм - Недостаток зрения {Недостаток}
дамочка - женщина (простореч {женщина}
данные - Сведения обстоятельства {Сведения}
дарвинист - Последователь дарвинизма {Последователь}
дата - время какого {время}
дача - Участок земли {Участок}
движенец - Рабочий службы {Рабочий}
двоеточие - Знак препинания {Знак}
двор - участок земли {участок}
дворничиха - Жена дворника {Жена}
двоякодышащие - Подкласс рыб {Подкласс}
двукопытные - Отряд млекопитающих {Отряд}
двукрылые - Отряды насекомых {Отряды}
двуполье - Способ обработки {Способ}
двурукие - отряд млекопитающих {отряд}
двурушничество - Поведение человека {Поведение}
дебаты - Прения обсуждения {Прения}
дебит - Количество воды {Количество}
деверь - Брат мужа {Брат}
девиация - Отклонение стрелки {Отклонение}
девчата - Девушки девочки {Девушки}
дегтярня - Место выгонки {Место}
дед - Отец отца {Отец}
деденька - Ласкат к {Ласкат}
дедукция - Метод мышления {Метод}
дедушка - Ласкат к {Ласкат}
деепричастие - наречие напр {наречие}
дезидераты - Предметы книги {Предметы}
дезориентация - Утрата способности {Утрата}
деист - Последователь деизма {Последователь}
действие - Проявление какой {Проявление}
действительность - Бытие какая {Бытие}
дек - палуба судна {палуба}
декабрист - Участник восстания {Участник}
декаграмм - мера веса {мера}
декада - промежуток времени {промежуток}
декадент - Представитель декадентства {Представитель}
декалитр - мера жидкостей {мера}
декалькомания - Способ перенесения {Способ}
декаметр - мера длины {мера}
деканат - управление факультета {управление}
деканство - Должность декана {Должность}
декатонна - мера веса {мера}
декларация - заявление налогоплательщика {заявление}
декорация - изображение места {изображение}
делимое - действии деления {действии}
делитель - действии деления {действии}
демимонд - Среда кокоток {Среда}
демимонденка - Женщина полусвета {Женщина}
демография - Отдел статистики {Отдел}
демонетизация - Лишение монеты {Лишение}
деморализация - Упадок духа {Упадок}
демпинг - Продажа товаров {Продажа}
дендизм - Образ жизни {Образ}
дендрология - Отдел ботаники {Отдел}
дензнак - Сокращение слов {Сокращение}
деноминация - Переименование стоимости {Переименование}
дентин - вещество зуба {вещество}
деньжонки - -уменьш к {-уменьш}
депо - Здание стоянки {Здание}
депозит - сумма денег {сумма}
деревня - селение деревни {селение}
деревообработка - Обработка дерева {Обработка}
деревяшка - кусок дерева {кусок}
дерматит - Воспаление кожи {Воспаление}
дерматоз - состояние кожи {состояние}
дерматология - Отдел медицины {Отдел}
дермографизм - Свойство кожи {Свойство}
дернина - Кусок дерна {Кусок}
десант - Отряд войска {Отряд}
десерт - Фрукты конфеты {Фрукты}
десть - Единица счета {Единица}
десятилетие - Промежуток времени {Промежуток}
детва - Личинки пчел {Личинки}
детерминист - Последователь детерминизма {Последователь}
детка - Ласкат к {Ласкат}
детонация - взрыв вещества {взрыв}
деторождение - Рождение детей {Рождение}
детскость - Ребячество характера {Ребячество}
дефляция - Сокращение количества {Сокращение}
деформация - Изменение формы {Изменение}
децентрализация - Система управления {Система}
децернат - организация управления {организация}
децернент - лицо какого {лицо}
дешёвка - цена распродажа {цена}
джингоист - Представитель джингоизма {Представитель}
джиу-джитсу - система борьбы {система}
джон-буль - прозвище англичан {прозвище}
диагноз - Определение болезни {Определение}
диагностика - Отрасль медицины {Отрасль}
диалектология - Отдел языковедения {Отдел}
диамат - Сокращение слов {Сокращение}
дидактика - Отдел педагогики {Отдел}
дина - Единица силы {Единица}
динамика - Отдел механики {Отдел}
диоптрия - Единица измерения {Единица}
дипломатия - политика сношения {политика}
директорат - Орган управления {Орган}
директория - Коллегия директоров {Коллегия}
директорша - Жена директора {Жена}
дирижаблестроение - Производство дирижаблей {Производство}
дисгармония - Нарушение гармонии {Нарушение}
дисквалификация - Лишение квалификации {Лишение}
дискобол - Метатель диска {Метатель}
дисконт - Учет векселей {Учет}
дискуссия - Обсуждение какого {Обсуждение}
дислокация - Расположение войск {Расположение}
диспансеризация - Система мероприятий {Система}
диспозиция - Расположение войск {Расположение}
дисциплина - членов какого {членов}
диэта - Режим питания {Режим}
диэтетика - Гигиена питания {Гигиена}
длина - Протяжение пути {Протяжение}
добро - буквы «д {буквы}
доброволец - ряды армии {ряды}
добровольчество - работа добровольцев {работа}
добродетель - качество человека {качество}
довольствие - снабжение (офиц {снабжение}
догаресса - Жена дожа {Жена}
догматика - Изложение догматов {Изложение}
дож - Глава республики {Глава}
дождинка - Капля дождя {Капля}
дожинки - день жатвы {день}
доза - количество лекарства {количество}
дойло - Количество молока {Количество}
докторство - степень доктора {степень}
докторша - Жена доктора {Жена}
долженствование - Необходимость того {Необходимость}
долихоцефалия - головы долихоцефала {головы}
доместикация - Приручение животных {Приручение}
домком - Сокращение слов {Сокращение}
домостроение - Постройка домов {Постройка}
донесение - сообщение каких {сообщение}
донжуан - Волокита человек {Волокита}
донос - Орудие борьбы {Орудие}
допуск - Право входа {Право}
дорога - Путь сообщения {Путь}
дороговизна - Состояние рынка {Состояние}
досада - Чувство раздражения {Чувство}
достаток - Отсутствие нужды {Отсутствие}
доцент - звание преподавателя {звание}
драгуны - Первонач род {Первонач}
драматизм - Напряженность действия {Напряженность}
древесина - вещество дерева {вещество}
древлехранилище - Хранилище древностей {Хранилище}
дреколье","дреколья - Дубины палки {Дубины}
дренаж - Осушение почвы {Осушение}
дриада - греч мифологии {греч}
дробилка - машина (см {машина}
дровозаготовка - Заготовка дров {Заготовка}
дрожь - сокращение мышц {сокращение}
дружок - Ласкат к {Ласкат}
друз - Группа минералов {Группа}
друидизм - Религия друидов {Религия}
дрязги - ссоры пререкания {ссоры}
дубильщик - дублением кожи {дублением}
дубление - Обработка кож {Обработка}
дубликат - экземпляр документа {экземпляр}
дубьё - Палки дубинки {Палки}
дуван - Дележ добычи {Дележ}
дуга - Принадлежность упряжи {Принадлежность}
дуло - отверстие ствола {отверстие}
думки - деньги (см {деньги}
дуновение - Порыв ветра {Порыв}
дурь - Глупость сумасбродство {Глупость}
духанщик - Содержатель духана {Содержатель}
духоборчество - движение духоборцев {движение}
дуэлянт - Участник дуэли {Участник}
дыба - Орудие пытки {Орудие}
дым - продукты горения {продукты}
дымка - пелена тумана {пелена}
дыня - плод растения {плод}
дыхальце - Органы дыхания {Органы}
дьявольщина - положение вещей {положение}
дьяконица - Жена дьякона {Жена}
дьяконство - Звание дьякона {Звание}
дьячиха - Жена дьячка {Жена}
дьячок - служитель культа {служитель}
дэ - буквы «д {буквы}
дюйм - Единица меры {Единица}
дюралюминий - сплав (алюминия {сплав}
дяденька - Ласкат к {Ласкат}
дядька - Дядя (пренебр {Дядя}
дядюшка - Ласкат к {Ласкат}
дядя - Брат отца {Брат}
е - буквы «е {буквы}
евангелист - Автор евангелия {Автор}
евразиец - Сторонник евразийства {Сторонник}
европа - частей света {частей}
егермейстер - придворных чинов {придворных}
егерь - охотник (устар {охотник}
египтянин - Уроженец Египта {Уроженец}
единоверие - Общность религии {Общность}
единовластие - Сосредоточение власти {Сосредоточение}
единомыслие - образ мыслей {образ}
единонаследие - Порядок наследования {Порядок}
единоначальник - Командир какой {Командир}
единообразие - Единство вида {Единство}
езопство - Поведение езопа {Поведение}
елеосвящение - наз таинств {наз}
еретик - Последователь ереси {Последователь}
ерундистика - набор слов {набор}
есаул - чин ротмистра {чин}
естествознание - науки науки {науки}
ефес - Рукоятка сабли {Рукоятка}
жабры - органы дыхания {органы}
жакт - Сокращение слов {Сокращение}
жало - Орган защиты {Орган}
жалоба - Выражение неудовольствия {Выражение}
жандармерия - Полицейские войска {Полицейские}
жар - степень нагретости {степень}
жара - температура воздуха {температура}
жгутик - Орган передвижения {Орган}
железина - Кусок железа {Кусок}
железка - кусок железа {кусок}
железосплав - Сплав железа {Сплав}
желтуха - Болезнь печени {Болезнь}
желчеотделение - Процесс выделения {Процесс}
жемчужина - зерно жемчуга {зерно}
жеребец - Самец лошади {Самец}
жеребьёвка - Вынимание жребиев {Вынимание}
жеребятина - Мясо жеребенка {Мясо}
жеребёнок - Детеныш лошади {Детеныш}
жертвоприношение - Обряд принесения {Обряд}
жерёбость - Беременность кобылицы {Беременность}
живгазета - газета (см {газета}
живец - Представитель т {Представитель}
живность - Домашние птицы {Домашние}
жид - устах антисемитов {устах}
жизнеописание - Описание жизни {Описание}
жилкование - Система распределения {Система}
жилстроительство - строительство См {строительство}
жим - Сила сжимания {Сила}
жировик - опухоль (обл {опухоль}
жирондист - Член партии {Член}
жмыхи - Остатки семян {Остатки}
жолудь - Плод дуба {Плод}
жор - клев рыбы {клев}
журавлиха - Самка журавля {Самка}
журавлёнок - Птенец журавля {Птенец}
журналистика - Литература журналов {Литература}
жюри - Группа экспертов {Группа}
забастовка - прекращение работы {прекращение}
забастовщик - Участник забастовки {Участник}
заболачивание - Образование болота {Образование}
заболеваемость - Появление болезней {Появление}
заболевание - Возникновение болезни {Возникновение}
заболонь - слой древесины {слой}
забытьё - потеря сознания {потеря}
зав - Сокращение слова {Сокращение}
зависимость - Подчинение чьей {Подчинение}
зависть - Чувство досады {Чувство}
завиток - прядь волос {прядь}
завихренние - Образование вихрей {Образование}
завком - Сокращение слов {Сокращение}
завкомовец - Член завкома {Член}
завхоз - Сокращение слов {Сокращение}
загар - цвет кожи {цвет}
заглавие - книги какого {книги}
заговенье - Канун поста {Канун}
заговорщик - Участник заговора {Участник}
заголовок - книги сочинения {книги}
загс - Отдел записи {Отдел}
задачник - Сборник задач {Сборник}
задел - скопление изделий {скопление}
задира - Зачинщик ссор {Зачинщик}
задолженность - Наличие долгов {Наличие}
задыхание - Состояние удушья {Состояние}
зажин - Начало жатвы {Начало}
зажор - Затор льда {Затор}
зазнайство - Образ действий {Образ}
заикание - расстройство речи {расстройство}
заимка - Занятие кем {Занятие}
заинька - Ласкат к {Ласкат}
зайка - Ласкат к {Ласкат}
займище - Полоса земли {Полоса}
займодержатель - Владелец облигаций {Владелец}
зайчиха - Самка зайца {Самка}
зайчонок - Детеныш зайца {Детеныш}
закись - степень окисления {степень}
заклад - Отдача какого {Отдача}
законник - толкователь законов {толкователь}
законоведение - Совокупность сведений {Совокупность}
законоположение - Постановление закона {Постановление}
законопроект - Проект закона {Проект}
законоучение - Учение какой {Учение}
законоучитель - Преподаватель закона {Преподаватель}
зам - Заместитель какого {Заместитель}
заместительство - исполнение обязанностей {исполнение}
замешательство - нарушение порядка {нарушение}
замзав - Сокращение слов {Сокращение}
замнарком - Заместитель наркома {Заместитель}
замок - Крепость феодала {Крепость}
зампред - Сокращение слов {Сокращение}
замужество - Состояние женщины {Состояние}
заноза - кусочек дерева {кусочек}
запад - стран романо {стран}
западник - Сторонник западничества {Сторонник}
запал - Эмфизема легких {Эмфизема}
запас - пользования продовольствие {пользования}
запах - Свойство предмета {Свойство}
запевка - Зачин песни {Зачин}
записка - Клочок бумаги {Клочок}
заплачка - Причитание невесты {Причитание}
заповедник - территория т {территория}
заполярье - области пространства {области}
запрячься - Сов к {Сов}
запятая - Знак препинания {Знак}
зарево - Отсвет пожара {Отсвет}
заречься - Сов к {Сов}
зарплата - Сокращение слов {Сокращение}
заря - окраска горизонта {окраска}
заряница - Эпитет зари {Эпитет}
засада - Прием борьбы {Прием}
засдамся - буд вр {буд}
заседательша - Жена заседателя {Жена}
застава - Место выезда {Место}
застенок - Место пыток {Место}
застой - Отсутствие прогресса {Отсутствие}
засуха - Недостаток воды {Недостаток}
затейник - Выдумщик человек {Выдумщик}
затин - полоса реки {полоса}
затишье - прекращение шума {прекращение}
затоваренность - Состояние сбыта {Состояние}
заток - край тканья {край}
зауряд - Звание лица {Звание}
захребетник - лености нерадивости {лености}
зачатие - Зарождение плода {Зарождение}
защёлка - задвижка род {задвижка}
заячина - Мясо зайца {Мясо}
звание - разряд (офиц {разряд}
звездопад - Время года {Время}
звездопоклонство - культ звезд {культ}
звездорыл - млекопитающее род {млекопитающее}
звеновик - Руководитель звена {Руководитель}
звенорг - Сокращение слов {Сокращение}
зверёнок - Детеныш зверя {Детеныш}
зверёныш - Детеныш зверя {Детеныш}
звук - движение частиц {движение}
звукообраз - Подбор звуков {Подбор}
звукоподражание - Выражение какого {Выражение}
звукопроводность - Способность тела {Способность}
здоровье - состояние организма {состояние}
здравотдел - Отдел здравоохранения {Отдел}
зеленя - всходы хлебов {всходы}
земледелие - Обработка земли {Обработка}
землемерша - Жена землемера {Жена}
землепашество - Обработка земли {Обработка}
землеудобрение - Удобрение земли {Удобрение}
землеустройство - Система мероприятий {Система}
землечерпание - Углубление дна {Углубление}
земля - буквы «з {буквы}
землячок - Ласкат к {Ласкат}
земотдел - Отдел земледелия {Отдел}
земство - Система учреждений {Система}
зенитка - орудие (см {орудие}
зеница - Зрачок глаз {Зрачок}
зерно - Семя растений {Семя}
зима - время года {время}
зимовье - Пребывание где {Пребывание}
злодей - Преступник человек {Преступник}
зложелательство - Желание зла {Желание}
змееборец - образ героя {образ}
змеепоклонство - культ поклонения {культ}
змеёныш - Детеныш змеи {Детеныш}
знание - Деятельность сознания {Деятельность}
зоб - Расширение пищевода {Расширение}
зодиак - Пояс неба {Пояс}
золовка - Сестра мужа {Сестра}
золотник - мера веса {мера}
золотопогонник - Офицер эпохи {Офицер}
золотуха - расстройство питания {расстройство}
зоопарк - парк См {парк}
зоосад - сад См {сад}
зубатовщина - борьбы самодержавия {борьбы}
зубило - инструмент род {инструмент}
зубристика - Система учения {Система}
зуд - расстройство чувствительности {расстройство}
зуй - нек птиц {нек}
зэ - буквы «з {буквы}
зять - Муж золовки {Муж}
игрок - Участник игры {Участник}
идеал - степень совершенства {степень}
идиллик - Автор идиллий {Автор}
идиом","идиома - Оборот речи {Оборот}
идиосинкразия - особенность организма {особенность}
идиш - язык евреев {язык}
иерархия - Порядок подчинения {Порядок}
иерейство - Сан иерея {Сан}
иждивенство - Положение иждивенца {Положение}
избирком - Сокращение слов {Сокращение}
изжога - Ощущение жжения {Ощущение}
излияние - вытекание откуда {вытекание}
изложница - отливки чугуна {отливки}
излёт - Момент движения {Момент}
измеритель - прибор (тех {прибор}
изнанка - сторона события {сторона}
изо - Сокращение слов {Сокращение}
изюм - ягоды винограда {ягоды}
изюмина - Ягодка изюма {Ягодка}
икона - изображение бога {изображение}
иконоборец - Последователь иконоборчества {Последователь}
икра - мышца ноги {мышца}
икра - Яички самок {Яички}
икрина - зернышко икры {зернышко}
икрометание - Метание икры {Метание}
икс","икс-лучи - конца буквы {конца}
иллюзионист - Последователь иллюзионизма {Последователь}
ильм - дерево род {дерево}
именослов - Список имен {Список}
имморализм - Отрицание общеобязательности {Отрицание}
император - титул монархов {титул}
империя - государство (истор {государство}
импрессионист - Последователь импрессионизма {Последователь}
импровизаторство - Деятельность импровизатора {Деятельность}
имя","именем","имени - обозначение человека {обозначение}
имярек - заменой имени {заменой}
инверсия - Перестановка слов {Перестановка}
индейка - Мясо индюшки {Мясо}
индетерминист - Последователь индетерминизма {Последователь}
индиго - краска (бот {краска}
индийцы - Жители Ост {Жители}
индоевропейцы - Народности нации {Народности}
индуизм - религии поклонников {религии}
индуктивизм - Склад мышления {Склад}
индукция - Метод мышления {Метод}
индусы - жители Индии {жители}
индюшка - Самка индюка {Самка}
индюшонок - Птенец индюшки {Птенец}
инерция - Свойство тел {Свойство}
инженерша - Жена инженера {Жена}
инициалы - буквы имени {буквы}
инкассо - Получение денег {Получение}
инквизитор - Судья инквизиции {Судья}
инкор - Сокращение слов {Сокращение}
инкубация - выведение цыплят {выведение}
инобытие - бытия чего {бытия}
инородец - Первонач человек {Первонач}
иночество - Жизнь инока {Жизнь}
инспекторство - Должность инспектора {Должность}
инспекторша - Жена инспектора {Жена}
инструкторство - деятельность инструктора {деятельность}
интеллектуалист - Последователь интеллектуализма {Последователь}
интеллигентство - Образ мыслей {Образ}
интеллигенция - слой работников {слой}
интервенционист - Сторонник интервенции {Сторонник}
интервью - Беседа представителя {Беседа}
интернационализация - Признание чего {Признание}
интернационализм - Политика пролетариата {Политика}
интернационалист - Сторонник интернационализма {Сторонник}
интерпеллянт","интерпелянт - Член парламента {Член}
интерпункция - Расстановка знаков {Расстановка}
интерференция - Явление взаимодействия {Явление}
интоксикация - Отравление организма {Отравление}
интриганство - Поведение интригана {Поведение}
интуитивист - Последователь интуитивизма {Последователь}
инфантилизм - недоразвитость организма {недоразвитость}
инфильтрат - Продукт инфильтрации {Продукт}
инфляция - увеличение количества {увеличение}
инъекция - Введение лекарств {Введение}
иодоформ - препаратов иода {препаратов}
иотация - Появление звука {Появление}
ипекакуана - растение (бот {растение}
ипподром","иподром - Участок земли {Участок}
ириска - конфета ириса {конфета}
искусство - деятельность приемов {деятельность}
исламизм - система ислама {система}
испечься - Сов к {Сов}
исполком - Сокращение слов {Сокращение}
исполкомщик - Член исполкома {Член}
исправдом - Сокращение слов {Сокращение}
исправник - Начальник полиции {Начальник}
исправница - Жена исправника {Жена}
исправность - Отсутствие повреждения {Отсутствие}
истина - Идеал познания {Идеал}
истмат - Сокращение слов {Сокращение}
историзм - принцип рассмотрения {принцип}
история - Совокупность фактов {Совокупность}
итог - Результат сложения {Результат}
иудаизм - система иудейства {система}
ихтиол - продукт перегонки {продукт}
ихтиология - Отдел зоологии {Отдел}
ишак - Помесь лошади {Помесь}
кабак - заведения (истор {заведения}
кабанина - Мясо кабана {Мясо}
кабатчик - Содержатель кабака {Содержатель}
каббала","кабала - учение (истор {учение}
каббалистика","кабалистика - науки знания {науки}
кабель - провод (тех {провод}
кабельтов - Мера длины {Мера}
каверза - Запутывание дела {Запутывание}
кавказец - Уроженец Кавказа {Уроженец}
казино - дом клуба {дом}
казначей - Хранитель казны {Хранитель}
казначейство - Место хранения {Место}
казначейша - Жена казначея {Жена}
кайловище - Рукоятка кайлы {Рукоятка}
какавелла - шелуха семян {шелуха}
каламбур - Игра слов {Игра}
календы - день месяца {день}
калибр - Размер диаметра {Размер}
каллиграфия - Искусство чистописания {Искусство}
каломель - Препарат ртути {Препарат}
калорийность - Количество калорий {Количество}
калориметрия - Отдел физики {Отдел}
калория - Количество теплоты {Количество}
каменобоец - разбиванием камня {разбиванием}
камергерша - Жена камергера {Жена}
камнесечение - Операция размельчения {Операция}
кампания - поход действия {поход}
камуфлет - взрыв мины {взрыв}
камчатник - камчатке т {камчатке}
камыш - трава семейства {трава}
канализация - Система труб {Система}
кантианец - Сторонник кантианства {Сторонник}
канцелярия - Отделение какого {Отделение}
канцлер - Председатель совета {Председатель}
каперс - кустарника (бот {кустарника}
капитал - Совокупность стоимостей {Совокупность}
капитализм - Способ производства {Способ}
капище - храм служения {храм}
капля - количество жидкости {количество}
капуцин - монах (бот {монах}
карамель - конфет леденцов {конфет}
карамелька - Конфета карамели {Конфета}
карандаш - палочка графита {палочка}
карат - Мера веса {Мера}
карбид - Соединение элементов {Соединение}
карбонат - соль минералов {соль}
карборунд - Соединение кремния {Соединение}
карга - Ворона (обл {Ворона}
каре - Построение пехоты {Построение}
карма - учению буддистов {учению}
карманьола - песня якобинцев {песня}
карта - Чертеж части {Чертеж}
картечина - пуль картечи {пуль}
картина - Произведение живописи {Произведение}
картотека - Собрание карточек {Собрание}
картофелезаготовка - Заготовка картофеля {Заготовка}
картофелина - штука картофеля {штука}
карьер - Место разработки {Место}
карьеризм - свойство карьериста {свойство}
касатка - Ласточка (обл {Ласточка}
каталектика - Прием стихосложения {Прием}
каталепсия - сокращение мышц {сокращение}
каталог - Перечень терминов {Перечень}
каталогизатор - Составитель каталога {Составитель}
католицизм - Вероисповедание католиков {Вероисповедание}
каузальность - связь явлений {связь}
кахетинцы - подразделение грузин {подразделение}
кашеварство - Занятие кашевара {Занятие}
кашка - Ласкат к {Ласкат}
кашкара - кустарника рододендрон {кустарника}
каюта - помещение купе {помещение}
квадратура - Превращение какой {Превращение}
кваканье - Крик лягушек {Крик}
квакуша","квакушка - Прозвище лягушки {Прозвище}
квант","кванта - количество какой {количество}
квартет - пьеса (муз {пьеса}
квартиро-бивак - Расположение войск {Расположение}
квартиронаниматель - Съемщик квартиры {Съемщик}
квартирохозяин - Съемщик квартиры {Съемщик}
кварц - Окись кремния {Окись}
квасцы - солей алюминия {солей}
квестура - Должность квестора {Должность}
квотация - Установление квоты {Установление}
кельня - Лопаточка каменщика {Лопаточка}
кельты - ветвей индоевропейцев {ветвей}
келья - комната монаха {комната}
кенаф - трава семейства {трава}
керосинщик - Продавец керосина {Продавец}
кибитка - повозка экипажа {повозка}
кивер - убор нек {убор}
кизильник - Куст кизила {Куст}
кизлярка - водка к {водка}
килограмм - Мера веса {Мера}
килограмметр - Единица измерения {Единица}
километр - Мера длины {Мера}
килоуатт","килоуатт-час - Мера измерения {Мера}
киндяк - ткань (истор {ткань}
кинематика - Отдел механики {Отдел}
кинетика - Отдел механики {Отдел}
киносъёмка - съемка См {съемка}
кинотехника - Техника оборудования {Техника}
кипсек - издание гравюр {издание}
киса - обозначение кошки {обозначение}
кислотность - Степень содержания {Степень}
кишечник - Совокупность кишок {Совокупность}
клавир - названий фортепьяно {названий}
кладовщик - Заведующий кладовой {Заведующий}
клака - Клакеры театра {Клакеры}
класс - группа предметов {группа}
классицизм - Система образования {Система}
клемма - Зажим гайка {Зажим}
клеппер","клепер - порода лошадей {порода}
клерикал - Сторонник клерикализма {Сторонник}
клестовка - Самка клеста {Самка}
клико - Марка шампанского {Марка}
климактерий - Период прекращения {Период}
климатология - Отдел метеорологии {Отдел}
клинопись - Алфавит буквы {Алфавит}
клир - Духовенство какой {Духовенство}
клубок - шариком нитки {шариком}
клюв - окончание рта {окончание}
кляузничество - Поведение кляузника {Поведение}
клёцки - Кусочки теста {Кусочки}
книговедение - Ведение записей {Ведение}
книгоед - нек насекомых {нек}
книголюб - Любитель книги {Любитель}
книгоноша - Служащий библиотеки {Служащий}
книгопечатание - процесс печатания {процесс}
книгопродавец - Продавец книг {Продавец}
книжка - отделов желудка {отделов}
княжич - сын князя {сын}
княжна - Дочь князя {Дочь}
князь - Предводитель войска {Предводитель}
кобзарство - Кобзари кобзаря {Кобзари}
кобылятина - Мясо кобылы {Мясо}
коварство - Черта характера {Черта}
кодекс - свод законов {свод}
кожа - покров животных {покров}
кожан - одежда (разг {одежда}
кожимит - Сокращение слов {Сокращение}
кожура - кожа плодов {кожа}
козлы - Передок экипажа {Передок}
козлятина - Мясо козла {Мясо}
козлёнок - Детеныш козы {Детеныш}
козырёк - Кусок кожи {Кусок}
козюля - Змея (обл {Змея}
козёл - Козлы (простореч {Козлы}
козёл - Самец козы {Самец}
кокетство - Свойство кокетки {Свойство}
колдоговор - договор См {договор}
коленопреклонение - Преклонение коленей {Преклонение}
колер - бешенства исступления {бешенства}
коллегия - состав учреждения {состав}
коллектив - Группа людей {Группа}
коллективист - Последователь коллективизма {Последователь}
коллекционер - Собиратель коллекций {Собиратель}
коллекционерство - Собирание коллекций {Собирание}
колодка - кусок дерева {кусок}
колок - участок леса {участок}
колонист - Житель колонии {Житель}
колонтитул - Строка надписи {Строка}
колорит - соотношение красок {соотношение}
колос - Соцветие большинства {Соцветие}
колотушка - удар кулака {удар}
колоша - количество руды {количество}
колтун - Болезнь волос {Болезнь}
колумбарий - Хранилище урн {Хранилище}
колхозник - Член колхоза {Член}
кольцевание - обмазка ствола {обмазка}
ком - Кусок какого {Кусок}
командарм - Сокращение слов {Сокращение}
командирша - Жена командира {Жена}
комбат - Сокращение слов {Сокращение}
комбед - Сокращение слов {Сокращение}
комбриг - Сокращение слов {Сокращение}
комвуз - Сокращение слов {Сокращение}
комдив - Сокращение слов {Сокращение}
комендатура - Помещение коменданта {Помещение}
комизм - сторона человека {сторона}
комиссарша - Жена комиссара {Жена}
комитетчик - Член комитета {Член}
комми - Служащий магазина {Служащий}
коммивояжёр","комивояжёр - Агент какого {Агент}
коммуна - Коллектив лиц {Коллектив}
компартия - партия см {партия}
компендий","компендиум - изложение какой {изложение}
компетенция - Круг полномочий {Круг}
компилятор - Автор компиляции {Автор}
комплект - набор каких {набор}
комплекция - характер телосложения {характер}
композиция - Теория составления {Теория}
комполка - Командир полка {Командир}
компонент - элемент чего {элемент}
комсомол - Сокращение слов {Сокращение}
комсомолец - Член комсомола {Член}
комфракция - фракция См {фракция}
конармия - армия См {армия}
конвенансы - Условность приличия {Условность}
конверсия - Изменение условий {Изменение}
кондиция - Условие договора {Условие}
кондуктор - Проводник поезда {Проводник}
коневодство - Разведение лошадей {Разведение}
конина - Мясо лошади {Мясо}
конклав - Совет кардиналов {Совет}
конкубинат - сожительство мужчины {сожительство}
коногон - Погонщик лошади {Погонщик}
конокрадство - Занятие конокрада {Занятие}
конопатка - Результат конопачения {Результат}
конопляник - Участок земли {Участок}
консерваторец - Студент консерватории {Студент}
консигнант - Владелец товара {Владелец}
консигнация - Способ продажи {Способ}
консистенция - состояние организма {состояние}
конскрипция - Система комплектования {Система}
конституционалист - Сторонник конституционализма {Сторонник}
конструктивист - Сторонник конструктивизма {Сторонник}
конструктор - Автор какой {Автор}
консульство - Канцелярия консула {Канцелярия}
консультация - Обсуждение какого {Обсуждение}
контингент - совокупность людей {совокупность}
контрактация - Система вербовки {Система}
контрнаступление - наступление противника {наступление}
контрреволюционер - деятель контрреволюции {деятель}
контур - Очертания какого {Очертания}
конферансье - Участник представления {Участник}
конфетти - кружочки к {кружочки}
конфискация - Отобрание денег {Отобрание}
концентр - Ступень обучения {Ступень}
кончина - Смерть (человека {Смерть}
конъюнктивит - Воспаление конъюнктивы {Воспаление}
конъюнктура - Совокупность условий {Совокупность}
кооперация - организации труда {организации}
кооптация - пополнение какой {пополнение}
копевладелец - Владелец копей {Владелец}
копна - куча сена {куча}
копотня - исполнение чего {исполнение}
копоть - Осадок дыма {Осадок}
копьё - Сторона монеты {Сторона}
корабельщик - Владелец корабля {Владелец}
кораблекрушение - Гибель корабля {Гибель}
кораблестроение - Постройка судов {Постройка}
коран - книга мусульман {книга}
коренья - Корни нек {Корни}
корифейка - Танцовщица кордебалета {Танцовщица}
корица - кора нек {кора}
корм - Пища животных {Пища}
кормач - Работник совхоза {Работник}
кормило - Руль судна {Руль}
корниловец - Участник корниловщины {Участник}
коробушка - Ласкат к {Ласкат}
королевич - Сын короля {Сын}
королевна - Дочь короля {Дочь}
король - Титул монарха {Титул}
коронация - церемония возложения {церемония}
корпус - Туловище (человека {Туловище}
корреспондент","член-корреспондент - Сотрудник газеты {Сотрудник}
корчмарь - Владелец корчмы {Владелец}
коса - прядей волос {прядей}
коса - полоса леса {полоса}
косец - Косарь (см {Косарь}
косметика - украшение лица {украшение}
космополитизм - Взгляды убеждения {Взгляды}
космы - Пряди волос {Пряди}
косноязычие - Расстройство речи {Расстройство}
косовище - Рукоятка косы {Рукоятка}
косогор - Склон горы {Склон}
косослой - расположение волокон {расположение}
кострец - теле человека {теле}
костюм - Одежда человека {Одежда}
косушка - Полбутылки водки {Полбутылки}
косяк - Гурт кобыл {Гурт}
кот - Самец кошки {Самец}
котёнок - Детеныш кошки {Детеныш}
кофеинка - Зернышко кофе {Зернышко}
кочан - Головка капусты {Головка}
кочевье - Стоянка кочевников {Стоянка}
кочка - Бугорок земли {Бугорок}
кош - Стан кочевников {Стан}
кошка - Самка кота {Самка}
кошкодав - Скупщик кошек {Скупщик}
кошма - кусок войлока {кусок}
краеведение - Изучение какого {Изучение}
крапивник - Заросли крапивы {Заросли}
крапивница - лихорадка (разг {лихорадка}
крапление - Нанесение крапа {Нанесение}
красавец - мужчина ком {мужчина}
краском - Сокращение слов {Сокращение}
краснуха - болезнь свиней {болезнь}
краюха - ломоть хлеба {ломоть}
креатура - Ставленник чей {Ставленник}
кредит - Счет лица {Счет}
кредитка - билет (см {билет}
кредо - убеждения основы {убеждения}
крекинг-процесс - Перегонка нефти {Перегонка}
кремация - Сжигание трупов {Сжигание}
кремешок - кусок кремня {кусок}
крен - Наклонение судна {Наклонение}
креозот - Продукт перегонки {Продукт}
крепостца - крепость (см {крепость}
крестины - Обряд крещения {Обряд}
крестком - комитет взаимопомощи {комитет}
кривошея - положение головы {положение}
крик - звук голоса {звук}
крикса - плач ребенка {плач}
кристалличность","кристаличность - строение чего {строение}
критиканство - Свойство критикана {Свойство}
крица - кусок железа {кусок}
кровинка - Капелька крови {Капелька}
кровоизлияние - Истечение крови {Истечение}
кровообращение - движение крови {движение}
кровоочищение - Очищение крови {Очищение}
кровопускание - Извлечение крови {Извлечение}
кровотечение - Истечение крови {Истечение}
кровохаркание - Выделение крови {Выделение}
кролиководство - разведение кроликов {разведение}
кроликоматка - Крольчиха (см {Крольчиха}
крольчиха - Самка кролика {Самка}
кромка - край доски {край}
кронпринцесса - Жена кронпринца {Жена}
круп - воспаление какого {воспаление}
крынка - сосуд жидкости {сосуд}
крысёнок - Детеныш крысы {Детеныш}
крючкотворство - нагромождение формальностей {нагромождение}
кряканье - Крик утки {Крик}
кряква - утка родоначальница {утка}
ксероформ - Соединение висмута {Соединение}
кубатура - объем какого {объем}
кудахтанье - Крик курицы {Крик}
кузьминки - Праздник Кузьмы {Праздник}
кукла - Подобие человека {Подобие}
кукование - Крик кукушки {Крик}
кулак - Кисть руки {Кисть}
кулачество - Кулаки (см {Кулаки}
кулинария - Искусство приготовления {Искусство}
кулон - Единица измерения {Единица}
кульминация - Прохождение светила {Прохождение}
культармеец - Участник культпохода {Участник}
культпроп - Отдел культуры {Отдел}
культурность - степень культуры {степень}
культуртрегерство - Деятельность культуртрегера {Деятельность}
культурфильм","культурфильма - фильм (фильма {фильм}
культячейка - Группа общественников {Группа}
кума - эпитет лисы {эпитет}
кунсткамера - Собрание редкостей {Собрание}
куплет - Строфа песни {Строфа}
куроводство - разведение кур {разведение}
курс - Направление корабля {Направление}
курсист - Слушатель курсов {Слушатель}
кусака - животное человек {животное}
кустик - куст (см {куст}
кухмистерша - Жена кухмистера {Жена}
куча - количество чего {количество}
кучки - Кущи (см {Кущи}
куш - сумма денег {сумма}
кущенье - Образование пучка {Образование}
лабиализация - Выдвижение губ {Выдвижение}
лава - Способ атаки {Способ}
лаванда - Полукустарник семейства {Полукустарник}
лагерь - Стоянка войск {Стоянка}
ладушки - песенке «Ладушки {песенке}
лай - Крик собаки {Крик}
лайнсмен - Помощник судьи {Помощник}
лак - Раствор смолы {Раствор}
лактация - Выделение молока {Выделение}
лама - Млекопитающее семейства {Млекопитающее}
ламаист - Последователь ламаизма {Последователь}
ландвер - контингент людей {контингент}
ландрин - Леденцы монпансье {Леденцы}
ланка - Самка оленя {Самка}
лань - Порода оленей {Порода}
ларингит - Воспаление гортани {Воспаление}
ласка - Проявление нежности {Проявление}
латвиец - Подданный Латвии {Подданный}
латунь - Сплав меди {Сплав}
лебедёнок - Птенец лебедя {Птенец}
лебёдка - Самка лебедя {Самка}
лебёдушка - Ласкат к {Ласкат}
лев - млекопитающее семейства {млекопитающее}
левада - Участок земли {Участок}
левачество - Образ мыслей {Образ}
левират - нек народов {нек}
легислатура - Период деятельности {Период}
легитимизм - Убеждения легитимиста {Убеждения}
легитимист - Сторонник монархии {Сторонник}
леди - Жена лорда {Жена}
ледорез - бык моста {бык}
ледостав - замерзание реки {замерзание}
ледоход - время замерзания {время}
ледышка - Кусок льда {Кусок}
лежбище - Место залегания {Место}
лейб-медик - врач См {врач}
лекарша - Жена лекаря {Жена}
лексика - Совокупность слов {Совокупность}
лексикография - Собирание слов {Собирание}
лексикология - Отдел языкознания {Отдел}
ленинизм - Учение Ленина {Учение}
ленто - темпе исполнения {темпе}
ленчик - Основа седла {Основа}
лень - Отсутствие желания {Отсутствие}
лесничество - Участок леса {Участок}
лесонасаждение - разведение леса {разведение}
лесосека - Участок леса {Участок}
лесоэкспорт - Экспорт леса {Экспорт}
лета - греч мифологии {греч}
лето - время года {время}
летописание - Составление летописей {Составление}
летописец - Составитель летописи {Составитель}
летопись - запись событий {запись}
летосчисление - система определения {система}
лжесвидетельство - показание свидетеля {показание}
либерал - Сторонник либерализма {Сторонник}
лигатура - Примесь меди {Примесь}
лидерство - Положение обязанности {Положение}
лизоблюдство - Поведение лизоблюда {Поведение}
лик - Кромка паруса {Кромка}
ликбез - Сокращение слов {Сокращение}
ликбезник - Работник ликбеза {Работник}
ликвидаторство - течение ликвидаторов {течение}
ликвидация - Прекращение деятельности {Прекращение}
линза - Хрусталик глаза {Хрусталик}
линия - Граница поверхности {Граница}
линкор - Сокращение слов {Сокращение}
лино - полотна батиста {полотна}
лирик - поэт (лит {поэт}
лист - органов растения {органов}
листаж - Количество листов {Количество}
листопад - Опадание листьев {Опадание}
лисёнок - Детеныш лисицы {Детеныш}
литератор - Писатель человек {Писатель}
литературоведение - Совокупность наук {Совокупность}
литр - Мера емкости {Мера}
литьё - Изготовление изделий {Изготовление}
лихач - человек (нар {человек}
лихачество - Поведение лихача {Поведение}
лицезрение - Созерцание кого {Созерцание}
лицеист - Воспитанник лицея {Воспитанник}
лог - овраг (обл {овраг}
логарифм - Показатель степени {Показатель}
логопедия - Исправление недостатков {Исправление}
лодочник - Содержатель лодки {Содержатель}
лоза - стебель нек {стебель}
локоть - Место соединения {Место}
лонжерон - брус рамы {брус}
лопари - народности саами {народности}
лопасть - конец чего {конец}
лорд-канцлер - Председатель палаты {Председатель}
лосиха","лосица - Самка лося {Самка}
лососина - Мясо лосося {Мясо}
лотерея - Розыгрыш вещей {Розыгрыш}
лохмы - волосы (пренебр {волосы}
лоция - наука кораблевождения {наука}
лошадник - Любитель лошадей {Любитель}
лошак - Помесь жеребца {Помесь}
луда - Сплав олова {Сплав}
лузга - Шелуха семян {Шелуха}
лупанар","лупанарий - Дом терпимости {Дом}
лучеиспускание - Свойство тел {Свойство}
лучепреломление - Преломление лучей {Преломление}
лучок - Ласкат к {Ласкат}
львица - Самка льва {Самка}
львёнок - Детеныш льва {Детеныш}
льдина - Глыба льда {Глыба}
льяло - отливки род {отливки}
льё - мера длины {мера}
любовь - Чувство привязанности {Чувство}
люди - буквы «л {буквы}
лягушонок - Детеныш лягушки {Детеныш}
маг - Волшебник чародей {Волшебник}
магазинщик - Владелец магазина {Владелец}
магазинщица - Служащая магазина {Служащая}
магнетизм - Свойство магнита {Свойство}
магнетон - количество магнетизма {количество}
мазила - живописец (пренебр {живописец}
мазок - Наложение краски {Наложение}
мазь - смесь жиров {смесь}
майор - звание лиц {звание}
майорша - Жена майора {Жена}
макаронина - штука макарон {штука}
макет - Модель чего {Модель}
маклерство - Профессия маклера {Профессия}
маковина - зернышко мака {зернышко}
маковка - Плод мака {Плод}
макроцефалия - Удлиненность черепа {Удлиненность}
максима - Правило поведения {Правило}
максималист - Сторонник максимализма {Сторонник}
макуха - Жмыхи семян {Жмыхи}
малайцы - население островов {население}
малинина - ягода малины {ягода}
малинник - Кусты малины {Кусты}
маловерие - Недостаток веры {Недостаток}
маловодье - уровень воды {уровень}
малолюдство - количество народа {количество}
малолюдье - количество людей {количество}
мальтузианец - Сторонник мальтузианства {Сторонник}
мальчишник - Пирушка жениха {Пирушка}
маменька - обозначение матери {обозначение}
мамушка - Ласкат к {Ласкат}
мандибулы - пара челюстей {пара}
маневр","манёвр - Передвижение паровозов {Передвижение}
манизм - Культ предков {Культ}
манипуляция - Движение руки {Движение}
манифестант - Участник манифестации {Участник}
манок - птица (см {птица}
мануфактурист - Владелец мануфактуры {Владелец}
мара - Призрак навождение {Призрак}
мараловодство - Разведение маралов {Разведение}
маральник - Питомник маралов {Питомник}
маримонда - Порода обезьян {Порода}
маринизм - политика усиления {политика}
марка - Знак оплаты {Знак}
марксизм - Система взглядов {Система}
маркёрство - Ремесло маркера {Ремесло}
мармеладина - Кусочек мармелада {Кусочек}
марсиане","марсияне - жители планеты {жители}
мартинист - Последователь мартинизма {Последователь}
мартиролог - Сборник повествований {Сборник}
маршрут - путь следования {путь}
маршрутизация - Организация перевозок {Организация}
масленица - праздник проводов {праздник}
маслоделие - Производство масла {Производство}
масляник - Продавец масла {Продавец}
маслёнщик - Смазчик машин {Смазчик}
масон - Последователь масонства {Последователь}
массаж - Растирание тела {Растирание}
масть - Цвет шерсти {Цвет}
матадор - бое быков {бое}
математика - Цикл наук {Цикл}
материнство - Беременность роды {Беременность}
матроска - Жена матроса {Жена}
мах - оборот (колеса {оборот}
мачеха - Жена отца {Жена}
машинизация - Снабжение чего {Снабжение}
машиностроение - производство машин {производство}
мгла - Завеса тумана {Завеса}
мгновение - промежуток времени {промежуток}
медведевые - Семейство млекопитающих {Семейство}
медведица - Самка медведя {Самка}
медвежонок - Детеныш медведя {Детеныш}
меделянка - порода догов {порода}
медицина - Цикл наук {Цикл}
междуначалие - Период времени {Период}
межень - уровень воды {уровень}
межплодник - слой стенки {слой}
межполосье - полоса земли {полоса}
мезга - Мякоть что {Мякоть}
мездра - плева животных {плева}
мелководье - уровень воды {уровень}
мелодия - последовательность звуков {последовательность}
мелок - Кусочек мела {Кусочек}
меломан - любитель пения {любитель}
мелочь - предметы что {предметы}
мельник - Владелец мельницы {Владелец}
мельхиор - Сплав меди {Сплав}
мемуарист - Автор мемуаров {Автор}
мениск - поверхность жидкости {поверхность}
меньшевик - Последователь меньшевизма {Последователь}
меньшинство - число чего {число}
меняла - разменом денег {разменом}
мера - Единица измерения {Единица}
мерило - Единица измерения {Единица}
мертвец - Умерший человек {Умерший}
местность - Место какое {Место}
местоимение - частей речи {частей}
местоположение - Расположение какого {Расположение}
месторождение - Место нахождения {Место}
месть - причинение зла {причинение}
месяц - Единица исчисления {Единица}
месячник - промежуток времени {промежуток}
мета - Метка помета {Метка}
металлист - Рабочий металлопромышленности {Рабочий}
металлургия - Отрасль техники {Отрасль}
метастаз - Перемещение возбудителя {Перемещение}
метафраза - Передача содержания {Передача}
метацентр - Точка пересечения {Точка}
метеор - явление напр {явление}
метеоризм - Вздутие живота {Вздутие}
метеорография - Описание метеоров {Описание}
метисация - Процесс скрещения {Процесс}
метловище - Рукоятка метлы {Рукоятка}
методизм - течение методистов {течение}
методика - Система правил {Система}
метр - единица длины {единица}
метраж - Длина кинофильма {Длина}
метранпаж - Рабочий типографии {Рабочий}
метрит - Воспаление матки {Воспаление}
метровка - метр (см {метр}
метёлка - метла (бот {метла}
механизм - устройство машины {устройство}
механика - Отдел физики {Отдел}
меценатство - Деятельность мецената {Деятельность}
мечта - Создание воображения {Создание}
мешок - Кусок холста {Кусок}
мешочничество - Спекуляция мешочников {Спекуляция}
мещанство - Сословие мещан {Сословие}
миг - промежуток времени {промежуток}
миграция - Передвижение капитала {Передвижение}
мизансцена - Размещение декораций {Размещение}
микроб - организм животного {организм}
микробиология - Отдел биологии {Отдел}
микрокосм - мир атомов {мир}
микрометрия - Отдел физики {Отдел}
микроцефалия - объем черепа {объем}
милашечка - Ласкат к {Ласкат}
милашка - Возлюбленная (простореч {Возлюбленная}
милитарист - Сторонник милитаризма {Сторонник}
милиционер - лицо милиции {лицо}
миллиардер - Обладатель богатства {Обладатель}
миллиардерша - Жена миллиардера {Жена}
миллиграмм - доля грамма {доля}
миллиметр - доля метра {доля}
миллионер - Обладатель богатства {Обладатель}
миллионерша - Жена миллионера {Жена}
миля - мера длины {мера}
миметизм - Свойство нек {Свойство}
мимика - Движения мышц {Движения}
мимикрия - воспроизведение нек {воспроизведение}
мина - мера веса {мера}
минерализация - Процесс образования {Процесс}
министериалист - Сторонник министериализма {Сторонник}
минорка - Порода кур {Порода}
минус - Знак вычитания {Знак}
минута - Мера времени {Мера}
мир","мир - согласные отношения {согласные}
мирабель - Порода сливы {Порода}
мировоззрение - Совокупность взглядов {Совокупность}
мироощущение - Отношение человека {Отношение}
миропонимание - Система понимания {Система}
мисс - девушки барышни {девушки}
миссионерство - Деятельность миссионера {Деятельность}
митра - убор епископов {убор}
мнемоника - Совокупность правил {Совокупность}
многоводье - Период времени {Период}
многолетие - долголетие слов {долголетие}
многолюдство - стечение народа {стечение}
многоначалие - Отсутствие единоначалия {Отсутствие}
многообразие - Множественность проявлений {Множественность}
многословие - Излишество слов {Излишество}
многотиражка - газета предприятия {газета}
многоточие - Знак препинания {Знак}
множимое - действии умножения {действии}
множитель - действии умножения {действии}
мобилизация - Перевод какой {Перевод}
мода - Совокупность привычек {Совокупность}
модернист - Последователь модернизма {Последователь}
модификация - Видоизменение преобразование {Видоизменение}
можжевелина - Ягода можжевельника {Ягода}
мозоль - Утолщение кожи {Утолщение}
молекула - частица вещества {частица}
молитвослов - Сборник молитв {Сборник}
молоки - железы рыб {железы}
молотило - рукоятке цепа {рукоятке}
молотовище - Рукоятка молота {Рукоятка}
молочность - Способность млекопитающего {Способность}
момент - отрезок времени {отрезок}
монарх - глава государства {глава}
монархист - Сторонник монархизма {Сторонник}
монархия - эпоху феодализма {эпоху}
монголоведение - Совокупность дисциплин {Совокупность}
монокультура - Культура какого {Культура}
монотония - Однообразие тона {Однообразие}
монтаньяры - партии Конвента {партии}
мордашка - личико (простореч {личико}
морена - Скопление обломков {Скопление}
моржиха - Самка моржа {Самка}
морковка - корешок моркови {корешок}
морковник - Кушанье род {Кушанье}
мороженщик - Продавец мороженого {Продавец}
морок - Мрак темнота {Мрак}
москатель - вещества (краски {вещества}
мотивация - Система доводов {Система}
мотовство - образ жизни {образ}
мотокада - Отряд мотоциклистов {Отряд}
моторизация - внедрение автотранспорта {внедрение}
мотыль - Личинка комара {Личинка}
мочалка - Пучок мочал {Пучок}
мочеиспускание - Испускание мочи {Испускание}
мошенник - Плут человек {Плут}
мрак - Отсутствие света {Отсутствие}
мракобес - Враг прогресса {Враг}
муженёк - Ласкат к {Ласкат}
мужик - устах «господ {устах}
мужичьё - устах «господ {устах}
муза - греч мифологии {греч}
мука - Продукт помола {Продукт}
мука","танталовы - страдание чем {страдание}
мультипликация - Киносъемка рисунков {Киносъемка}
муляж - Отливка моделей {Отливка}
мускат - семя плодов {семя}
мутация - изменение явлений {изменение}
муфта - сторон мешка {сторон}
мученичество - Состояние мученика {Состояние}
муштра - система воспитания {система}
мцыри - Послушник монастыря {Послушник}
мыловарение - Производство мыла {Производство}
мыслете - буквы «м {буквы}
мычанье - Крик коровы {Крик}
мышонок - Детеныш мыши {Детеныш}
мышца - Орган движения {Орган}
мэрия - Управление муниципалитета {Управление}
мягкосердечие - Мягкость сердца {Мягкость}
мякоть - части тела {части}
мясник - Торговец мясом {Торговец}
мясо - мышц убитых {мышц}
мясозаготовка - Заготовка мяса {Заготовка}
мятежник - Участник мятежа {Участник}
мяуканье - Крик кошки {Крик}
навага - рыба семейства {рыба}
наводнение - Затопление суши {Затопление}
навоз - смесь помета {смесь}
наголовник - убор сбруи {убор}
нагул - Количество жира {Количество}
надзирательша - Жена надзирателя {Жена}
надкрылья - крылья жуков {крылья}
надсада - напряжение сил {напряжение}
надхрящница - Оболочка хряща {Оболочка}
название - обозначение вещи {обозначение}
налогоплательщик - Плательщик налогов {Плательщик}
наместник - Заместитель митрополита {Заместитель}
наместница - Жена наместника {Жена}
намыв - Участок берега {Участок}
нанос - Слой земли {Слой}
нападки - Порицание придирки {Порицание}
наперсник - Любимец человек {Любимец}
написание - Характер изображения {Характер}
напрячься - Сов к {Сов}
напутствие - Слова пожелания {Слова}
наркоз - потерей сознания {потерей}
нарком - Сокращение слов {Сокращение}
наркомат - Сокращение слов {Сокращение}
народник - Последователь народничества {Последователь}
народоволец - Член партии {Член}
народонаселение - Население страны {Население}
нарсуд - суд См {суд}
наружность - Внешность черты {Внешность}
нарцеин - Препарат опия {Препарат}
населённость - Густота населения {Густота}
насилие - Применение силы {Применение}
наслаждение - степень удовольствия {степень}
настоятельство - Должность настоятеля {Должность}
настроение - состояние дел {состояние}
настроенность - Состояние духа {Состояние}
насыпь - возвышение нагрузки {возвышение}
нативист - Последователь нативизма {Последователь}
натурфилософ - Последователь натурфилософии {Последователь}
наука - Система знаний {Система}
национализация - Изъятие имущества {Изъятие}
националист - Приверженец национализма {Приверженец}
начин - Начало чего {Начало}
начсостав - состав см {состав}
наш - буквы «н {буквы}
нашествие - Вторжение неприятеля {Вторжение}
наяда - греч мифологии {греч}
неблагодарность - Отсутствие признательности {Отсутствие}
неблагозвучие - сочетание звуков {сочетание}
небожитель - Обитатель неба {Обитатель}
невежество - Отсутствие познаний {Отсутствие}
невезение - стечение обстоятельств {стечение}
неверие - Отсутствие веры {Отсутствие}
невестка - Жена брата {Жена}
невольничество - Состояние невольника {Состояние}
неволя - Отсутствие свободы {Отсутствие}
неврит - Воспаление нерва {Воспаление}
неврология - Отдел анатомии {Отдел}
невропатология - Отрасль медицины {Отрасль}
невыгода - Отсутствие выгоды {Отсутствие}
невязка - Несхождение линий {Несхождение}
недовыпуск - Выпуск продукции {Выпуск}
недовыработка - Выработка чего {Выработка}
недоговорённость - Замалчивание чего {Замалчивание}
недоделка - Незаконченность работы {Незаконченность}
недодержка - готовности продолжительность {готовности}
недожин - количество сжатого {количество}
недоимочность - Наличие недоимок {Наличие}
недоимщик - Плательщик налога {Плательщик}
недокорм - дача корма {дача}
недомол - размол зерна {размол}
недоносок - ребенок человек {ребенок}
недоумение - Состояние нерешимости {Состояние}
недоумие - Недостаток ума {Недостаток}
недочёт - Недостаток чего {Недостаток}
недруг - Враг человек {Враг}
нежелание - Отсутствие желания {Отсутствие}
незадача - стечение обстоятельств {стечение}
незлобивость - Кротость добродушие {Кротость}
неисполнение - Неосуществление чего {Неосуществление}
нейтрон - ядро атома {ядро}
некомплект - Отсутствие комплекта {Отсутствие}
нектар - греч мифологии {греч}
нелады - Недоразумения ссоры {Недоразумения}
немилость - Нерасположение лица {Нерасположение}
немота - Отсутствие способности {Отсутствие}
немощь - упадок сил {упадок}
немчура - немца немки {немца}
ненадобность - Отсутствие потребности {Отсутствие}
непонимание - Отсутствие понимания {Отсутствие}
непотизм - покровительство родственникам {покровительство}
непрерывка - организация работы {организация}
непривычка - Отсутствие привычки {Отсутствие}
непротивленец - Последователь учения {Последователь}
неравенство - подавление трудящихся {подавление}
неравноправие - Отсутствие равноправия {Отсутствие}
неразлучники - породы попугаев {породы}
нерв - пучков волокон {пучков}
нервация - Распределение жилок {Распределение}
нереида - греч мифологии {греч}
нерешимость - Отсутствие твердости {Отсутствие}
неряшество - Поведение неряхи {Поведение}
несовпадение - Отсутствие совпадения {Отсутствие}
несогласие - Отсутствие согласия {Отсутствие}
несоответствие - Отсутствие соответствия {Отсутствие}
несработанность - Отсутствие слаженности {Отсутствие}
несудимость - Отсутствие судимости {Отсутствие}
нетерпимость - Отсутствие терпимости {Отсутствие}
нетление - Отсутствие тления {Отсутствие}
неувязка - Отсутствие увязки {Отсутствие}
неудача - Отсутствие удачи {Отсутствие}
неумение - Недостаток навыков {Недостаток}
неуплата - Невзнос платы {Невзнос}
неурожай - сбор хлебов {сбор}
неуспех - Отсутствие успеха {Отсутствие}
неустройство - Отсутствие порядка {Отсутствие}
нефрит - Воспаление почек {Воспаление}
нехватка - Недостаток чего {Недостаток}
нигилизм - Образ мыслей {Образ}
нигилист - устах реакционеров {устах}
низина - высота чего {высота}
низкопоклонничество","низкопоклонство - Поведение низкопоклонника {Поведение}
низовка - аппарат кооперации {аппарат}
никелин - Сплав меди {Сплав}
нимфа - греч мифологии {греч}
нищенство - Собирание милостыни {Собирание}
новаторство - Новизна нововведения {Новизна}
новелла - повесть эпохи {повесть}
новеллист - Автор новелл {Автор}
новолуние - фаз луны {фаз}
нога - конечностей человека {конечностей}
ноговица - Принадлежность обуви {Принадлежность}
ноздря - отверстий носа {отверстий}
номер - число предмета {число}
нос - Орган обоняния {Орган}
носоглотка - отдел глотки {отдел}
нот - Сокращение слов {Сокращение}
нотница - Библиотека нот {Библиотека}
нотопечатание - Печатание нот {Печатание}
ночное - Пастьба лошадей {Пастьба}
нравоописание - Описание жизни {Описание}
нравственность - Совокупность норм {Совокупность}
нуждаемость - Степень нужды {Степень}
нэп - Сокращение слов {Сокращение}
обалдение - Состояние одурения {Состояние}
обвалка - Отделение мяса {Отделение}
обвес - -н материала {-н}
обед - Прием пищи {Прием}
обезличка - Система работы {Система}
обжимок - комок чего {комок}
обирала - Вымогатель человек {Вымогатель}
обиход - уклад жизни {уклад}
обком - Сокращение слов {Сокращение}
обладание - пользование чем {пользование}
областник - Сторонник областничества {Сторонник}
облитерация - Закрытие просветов {Закрытие}
обломок - кусок чего {кусок}
обморок - потеря сознания {потеря}
обновленец - Сторонник обновленчества {Сторонник}
обножка - Пыльца цветов {Пыльца}
обоз - Группа подвод {Группа}
оборонец - Сторонник защиты {Сторонник}
оборончество - Политика обороны {Политика}
оборот - круг вращения {круг}
оборотность - Количество оборотов {Количество}
оборочка - Ласкат к {Ласкат}
обращаемость - Нахождение чего {Нахождение}
обрубок - кусок дерева {кусок}
обрывность - Наличие обрывов {Наличие}
обрюхаченный - Прич страд {Прич}
обскурант - Враг науки {Враг}
обструкционист - Участник обструкции {Участник}
обструкция - Протест участника {Протест}
обхождение - Манера поведения {Манера}
общество - Совокупность людей {Совокупность}
обществоведение - Совокупность наук {Совокупность}
община - организация жителей {организация}
обыватель - житель какой {житель}
обыск - Осмотр кого {Осмотр}
обязанность - выполнению кем {выполнению}
овация - знаки одобрения {знаки}
овод - насекомое род {насекомое}
овца - Самка барана {Самка}
овцеводство - разведение овец {разведение}
овёс - растение зерна {растение}
оглавление - Перечень глав {Перечень}
огнеметание - Извержение струи {Извержение}
огнепоклонничество","огнепоклонство - Культ огня {Культ}
огниво - Кусок камня {Кусок}
огород - Участок земли {Участок}
огородник - Владелец огорода {Владелец}
огрызок - кусок чего {кусок}
огрёбки - Остатки сена {Остатки}
одежда - Совокупность предметов {Совокупность}
одноглазка - существо (нар {существо}
однолеток - Ровесник человек {Ровесник}
одночасье - Промежуток времени {Промежуток}
одурь - Помрачение сознания {Помрачение}
ожог - повреждение ткани {повреждение}
озорство - Поведение шалуна {Поведение}
океанография - Отдел геофизики {Отдел}
окись - степень окисления {степень}
окказионалист - Сторонник окказионализма {Сторонник}
окклюзия - Явление поглощения {Явление}
оклад - Размер какого {Размер}
околичность - делу подробности {делу}
околоплодник - Стенка плода {Стенка}
окорка - Очистка дерева {Очистка}
окосье - Рукоятка косы {Рукоятка}
окрол - Роды крольчихи {Роды}
октава - тон (муз {тон}
оленеводство - разведение оленей {разведение}
оленевые - Семейство млекопитающих {Семейство}
оленина - Мясо оленя {Мясо}
оленёнок - Детеныш оленя {Детеныш}
олеография - Способ печатания {Способ}
олимпиада - Греции (истор {Греции}
ольшняк - Группа кустов {Группа}
ом - Единица измерения {Единица}
омег - растений (бот {растений}
омоложение - Повышение жизнеспособности {Повышение}
омонимика - Отдел лексикологии {Отдел}
омонимия - Одинаковость слов {Одинаковость}
онкология - Отдел медицины {Отдел}
ономатология - Отдел языкознания {Отдел}
онтогенез","онтогенезис - Процесс развития {Процесс}
оология - Отдел зоологии {Отдел}
опекунство - Должность обязанности {Должность}
опивки - остатки того {остатки}
опиекурильня - Курильня опиума {Курильня}
опилки - порошок части {порошок}
опись - Список имущества {Список}
ополченец - Военнослужащий ополчения {Военнослужащий}
опорос - Роды свиньи {Роды}
оппортунизм - Политика приспособления {Политика}
определитель - собою что {собою}
опробковение - изменение оболочек {изменение}
оптация - Выбор гражданства {Выбор}
оптика - Отдел физики {Отдел}
орава - скопление людей {скопление}
орбита - Путь движения {Путь}
органон - Орудие мышления {Орудие}
ординар - уровень воды {уровень}
ордината - системе координат {системе}
ординатура - Должность ординатора {Должность}
орех - Плод нек {Плод}
ориентализм - Изучение Востока {Изучение}
орлица - Самка орла {Самка}
орлёнок - Птенец орла {Птенец}
орнамент - украшение мелодии {украшение}
орнитология - Отдел зоологии {Отдел}
ортодоксия - следование какому {следование}
ортопедия - Отдел хирургии {Отдел}
ортоцентр - Точка пересечения {Точка}
орфография - Правила правописания {Правила}
осведомленность - Наличие сведений {Наличие}
осень - времен года {времен}
осетрина - Мясо осетра {Мясо}
ослица - Самка осла {Самка}
ослышка - Ошибка слуха {Ошибка}
ослятина - Мясо осла {Мясо}
ослёнок - Детеныш осла {Детеныш}
оссеин - вещество костей {вещество}
ост - Сокращение слов {Сокращение}
останки - Тело покойника {Тело}
остеология - Отдел анатомии {Отдел}
остеречься - Сов к {Сов}
остит - Воспаление кости {Воспаление}
остов - каркас сооружения {каркас}
остойчивость - Способность судна {Способность}
остриё - кончик какого {кончик}
островитянин - Житель острова {Житель}
остяки - народности хантэ {народности}
отара - гурт овец {гурт}
отброс - остаток чего {остаток}
отверстие - Вход куда {Вход}
отвычка - Утрата привычки {Утрата}
отгонка - Отделение чего {Отделение}
отжиг - обработка металла {обработка}
отжимок - Комок вещества {Комок}
отжиток - современности человек {современности}
отзвук - Отражение звука {Отражение}
отзовист - Сторонник отзовизма {Сторонник}
отлив - понижение уровня {понижение}
оторочка - полоска материи {полоска}
отпирательство - отрицание чего {отрицание}
отплеск - Всплеск воды {Всплеск}
отплытие - Отход (судна {Отход}
отпор - Отражение нападения {Отражение}
отпрыск - побег растения {побег}
отпущение - Прощение (грехов {Прощение}
отродье - -н породы {-н}
отроек - рой пчел {рой}
отросток - ответвление какого {ответвление}
отруб - участок земли {участок}
отряд - Группа войск {Группа}
отсидка - Отбывание наказания {Отбывание}
отточие - ряд точек {ряд}
отче - Зват п {Зват}
отчизна - Отечество родина {Отечество}
отчим - Муж матери {Муж}
отчуждённость - Состояние отчуждения {Состояние}
офит - Минерал род {Минерал}
официант - Работник ресторана {Работник}
офсет - Способ печатания {Способ}
офтальмия - Болезнь глаз {Болезнь}
охлократия - Господство толпы {Господство}
охмеление - Состояние человека {Состояние}
охранка - отделения см {отделения}
очарование - Действие чар {Действие}
очелье - щиток кокошника {щиток}
очковтирательство - Втирание очков {Втирание}
очкур - Пояс опояска {Пояс}
ошеломление - Состояние того {Состояние}
па - фигура танца {фигура}
пава - Самка павлина {Самка}
паводок - скопление воды {скопление}
пагинация - Нумерация страниц {Нумерация}
падеж - имени (см {имени}
падишах - Титул нек {Титул}
паж - средине века {средине}
палец - частей кисти {частей}
палея - завет (истор {завет}
палисандр - древесина нек {древесина}
палуба - Настилка (обл {Настилка}
пальпитация - биение сердца {биение}
памфлетист - Автор памфлета {Автор}
памятованье - Сохранение чего {Сохранение}
панариций - воспаление тканей {воспаление}
панбархат - ткань род {ткань}
пандекты - Сборник решений {Сборник}
панегирист - Автор панегирика {Автор}
панкреатин - сок (см {сок}
панночка - Ласкат к {Ласкат}
пансионер - Учащийся пансиона {Учащийся}
панславист - Сторонник панславизма {Сторонник}
пантач - пантами (см {пантами}
пантеист - Последователь пантеизма {Последователь}
панцырь - туловище бойца {туловище}
папанинцы - исследователи Арктики {исследователи}
папенька - обозначение отца {обозначение}
папист - Сторонник папизма {Сторонник}
папочка - Ласкат к {Ласкат}
папушовка - Связывание листьев {Связывание}
параграф - подразделение текста {подразделение}
парад - смотр войск {смотр}
парадигм","парадигма - Таблица форм {Таблица}
паразитство - Поведение паразита {Поведение}
парамнезия - Расстройство памяти {Расстройство}
парвеню - языке аристократов {языке}
парильня - Отделение фабрики {Отделение}
парламентарий - Член парламента {Член}
парнас - Мир поэзии {Мир}
парная - Отделение бани {Отделение}
парнокопытные - Отряд млекопитающих {Отряд}
пародист - Автор пародий {Автор}
пароксизм - приступ какого {приступ}
парообразование - Образование пара {Образование}
парораспределение - Распределение пара {Распределение}
парсек - Единица измерения {Единица}
партбилет - Билет члена {Билет}
партгруппа - организация см {организация}
партдисциплина - дисциплина см {дисциплина}
партконференция - конференция см {конференция}
партнёр - Соучастник игры {Соучастник}
парторган - орган см {орган}
парторганизация - организация см {организация}
партработа - работа см {работа}
партработник - работник см {работник}
партсобрание - собрание см {собрание}
партсъезд - съезд см {съезд}
партшкола - школа см {школа}
парша - болезнь кожи {болезнь}
пасевки","пасевни - Остатки семян {Остатки}
пасквилянт - Автор пасквиля {Автор}
паскудник - мерзости гадости {мерзости}
пасс - Движение рук {Движение}
пассивирование - обработка поверхности {обработка}
пассия - Предмет любви {Предмет}
паства - Группа верующих {Группа}
пастеризация - Предохранение жидкостей {Предохранение}
пасторша - Жена пастора {Жена}
пасынок - сын с {сын}
пасьянс - кучки карт {кучки}
патетика - Присутствие чего {Присутствие}
патлы - пряди волос {пряди}
патристика - Изучение произведений {Изучение}
патрон - Соединение заряда {Соединение}
паук - животное служащих {животное}
пахтальщик - пахтаньем масла {пахтаньем}
пацифизм - Пропаганда мира {Пропаганда}
пацифист - Сторонник пацифизма {Сторонник}
пачеси - вычески льна {вычески}
паяльник - кусок меди {кусок}
педантство - Образ действий {Образ}
педвуз - Сокращение слов {Сокращение}
педерастия - отношения мужчины {отношения}
педфак - Сокращение слов {Сокращение}
пейзаж - Картина природы {Картина}
пейсы - пряди волос {пряди}
пелена - Покрывало (устар {Покрывало}
пенаты - дом очага {дом}
пеня - законом обязательств {законом}
пепелище - место пожара {место}
пептон - Продукт распада {Продукт}
первоисточник - источник каких {источник}
первопричина - причина чего {причина}
перга - Пыльца цветов {Пыльца}
пергамент - Кожа животных {Кожа}
пергидроль - Перекись водорода {Перекись}
перебой - Неровность биенья {Неровность}
перебор - Излишек чего {Излишек}
перевертень - Оборотень (обл {Оборотень}
перевыборы - выборы (см {выборы}
перегонка - Разложение веществ {Разложение}
перед","перёд - сторона чего {сторона}
пережиток - Остаток прошлого {Остаток}
перезрелка - дева (см {дева}
перекись - степень окисления {степень}
перекрёсток - Место пересечения {Место}
перемочься - Сов к {Сов}
перенаём - Наем какого {Наем}
переносок - младенец (см {младенец}
переприём - Прием (телеграмм {Прием}
перепёлка - Самка перепела {Самка}
перерасход - расход чего {расход}
пересекаемость - Возможность пересечения {Возможность}
перескачка - скачка лошадей {скачка}
перестой - Состояние чего {Состояние}
перестрига - Шерсть овцы {Шерсть}
пересуд - разбирательство (старин {разбирательство}
переучёт - учет (векселей {учет}
перешеек - полоса земли {полоса}
перикардит - Воспаление перикардия {Воспаление}
периметр - Сумма длины {Сумма}
период - Промежуток времени {Промежуток}
периостит - Воспаление периостата {Воспаление}
перипатетизм - Учение перипатетиков {Учение}
перистальтика - движения червя {движения}
перистокрылые - Семейство жуков {Семейство}
перитонит - Воспаление брюшины {Воспаление}
периферия - Окружность круга {Окружность}
перл - Жемчуг (устар {Жемчуг}
перманент - завивке волос {завивке}
персонал - служащие какого {служащие}
перст - Палец руки {Палец}
перуанцы - Население республики {Население}
перуны - Символ грозы {Символ}
перхота - Ощущение щекотания {Ощущение}
перхоть - частички чешуйки {частички}
перчатка - -н материи {-н}
песня - произведение (муз {произведение}
пестик - орган цветка {орган}
петлюровец - Сторонник Петлюры {Сторонник}
петля - конец веревки {конец}
петрография - Отдел геологии {Отдел}
петунья - растение семейства {растение}
пеховье - Рукоятка пешни {Рукоятка}
печерица - гриб (обл {гриб}
печёнка - Печень (простореч {Печень}
пещь - Печь (см {Печь}
пи - Отношение длины {Отношение}
пиано - силу звука {силу}
пивнушка - см пивной {см}
пивоварение - Изготовление пива {Изготовление}
пигментация - Отложение пигментов {Отложение}
пиетист - Сторонник пиетизма {Сторонник}
пик - вершина горы {вершина}
пикет - отряд рабочих {отряд}
пикетаж - Отметка пикетов {Отметка}
пикетчик - Участник пикета {Участник}
пиктография - система письма {система}
пила-рыба - рыба род {рыба}
пилотка - убор пилота {убор}
пимы - народов СССР {народов}
пинакотека - Собрание произведений {Собрание}
пинта - Мера емкости {Мера}
пионерия - Пионеры (см {Пионеры}
пиратство - Занятие пирата {Занятие}
пиротехника - Искусство изготовления {Искусство}
пируэт - поворот лошади {поворот}
письмена - знаки начертания {знаки}
письмовник - Сборник образцов {Сборник}
письмоводитель - Служащий канцелярии {Служащий}
письмоводительство - Должность письмоводителя {Должность}
письмоводство - Ведение корреспонденции {Ведение}
питух - Пьяница человек {Пьяница}
пифагореизм - Учение др {Учение}
пища - целью насыщения {целью}
плавник - орган плавания {орган}
плавун - слой подпочвы {слой}
плагиаторство - Занятие плагиатора {Занятие}
планеризм - Искусство полетов {Искусство}
плантатор - Хозяин плантации {Хозяин}
плантаторство - Деятельность плантатора {Деятельность}
пласт - слой чего {слой}
пластика - Искусство ваяния {Искусство}
пластина - полоса какого {полоса}
пластинчатожаберные - животных типа {животных}
платинотипия - Способ фотографирования {Способ}
платок - Кусок ткани {Кусок}
платонизм - философия др {философия}
плащаница - кусок ткани {кусок}
плевок - сгусток слюны {сгусток}
плеврит - Воспаление плевры {Воспаление}
племянник - Сын сестры {Сын}
племянница - Дочь сестры {Дочь}
плен - Состояние зависимости {Состояние}
пленум - Собрание какой {Собрание}
плеоназм - Оборот речи {Оборот}
плесень - Мицелий гриба {Мицелий}
плеяда - Группа близких {Группа}
плита - кусок камня {кусок}
плодоизгнание - Изгнание плода {Изгнание}
плодопереработка - Процесс переработки {Процесс}
плодосбор - Сбор плодов {Сбор}
плодосмен - система севооборота {система}
площадка - место постройки {место}
плутократия - Образ правления {Образ}
плутонг - отряд пехотинцев {отряд}
плюсконосные - Группа растений {Группа}
плюшкинство - скупость см {скупость}
пневмония - Воспаление легких {Воспаление}
побежалость - Свойство металла {Свойство}
побережье - Полоса земли {Полоса}
побоище - битва (старин {битва}
поведение - Совокупность поступков {Совокупность}
поверхность - сторона предмета {сторона}
повидло - вещество род {вещество}
повстанец - Участник восстания {Участник}
повязка - кусок ткани {кусок}
повёртка - Поворот дороги {Поворот}
погода - Состояние атмосферы {Состояние}
поголовье - число (голов {число}
подагра - болезнь суставов {болезнь}
подачка - Кусок еды {Кусок}
подвид - совокупность особей {совокупность}
подвижник - Аскет человек {Аскет}
подвижничество - Образ жизни {Образ}
подводчик - Возчик подводы {Возчик}
подгонщик - Помощник выжлятника {Помощник}
подгорье - склон горы {склон}
подготовленность - Наличие подготовки {Наличие}
подгруппа - Подразделение группы {Подразделение}
подгузник - Кусок ткани {Кусок}
поддёв - Ловля рыбы {Ловля}
поддёвка - одежда (обл {одежда}
подзолообразование - Процесс образования {Процесс}
подкласс - систематике животных {систематике}
подконюший - Помощник конюшего {Помощник}
подлежащее - член предложения {член}
подлекарь - Помощник лекаря {Помощник}
подлисок - лисица лисы {лисица}
подложность - Отвлеч суш {Отвлеч}
подмастер - Помощник мастера {Помощник}
подмор - дно улья {дно}
поднаём - Наем (помещения {Наем}
подобие - Образ чего {Образ}
подол - край пола {край}
подонки - Остатки жидкости {Остатки}
подполковница - Жена подполковника {Жена}
подпор - Подъем воды {Подъем}
подпоручик - чин прапорщика {чин}
подпункт - Раздел текста {Раздел}
подсед - слой растений {слой}
подтоварник - бревна жерди {бревна}
подторжье - Канун ярмарки {Канун}
подчасок - Помощник часового {Помощник}
подчинённость - Состояние подчинения {Состояние}
подшкипер - Помощник шкипера {Помощник}
подштурман - Помощник штурмана {Помощник}
пожар - Распространение огня {Распространение}
пожелание - желание чего {желание}
пожинки - Конец жатвы {Конец}
позднеспелость - Свойство (плодов {Свойство}
позитура - Положение тела {Положение}
позиционность - Условия ведения {Условия}
позиция - Положение тела {Положение}
познаваемость - Возможность познания {Возможность}
позолота - слой золота {слой}
пойма - время половодья {время}
поклонник - почитатель ухаживатель {почитатель}
поклёвка - момент клёва {момент}
покой - Отсутствие движения {Отсутствие}
покой - буквы «п {буквы}
поколение - определении родства {определении}
покрой","покроя - фасон одежды {фасон}
покрывало - Кусок ткани {Кусок}
полбутылки - Половина бутылки {Половина}
полвека - Половина века {Половина}
полгода - Половина года {Половина}
полголоса - Половина голоса {Половина}
полгорода - Половина города {Половина}
полдела - Половина дела {Половина}
полдень - Середина дня {Середина}
полдня - Половина дня {Половина}
полдороги - Половина дороги {Половина}
полдюжины - Половина дюжины {Половина}
полеводство - Отрасль земледелия {Отрасль}
полегаемость - Наличие полегания {Наличие}
полемист - Любитель полемики {Любитель}
полено - кусок дерева {кусок}
полжизни - Половина жизни {Половина}
полиандрия - полигамии (см {полигамии}
полигиния - полигамии (см {полигамии}
полиграфия - отрасли производства {отрасли}
полиморфизм - Существование особей {Существование}
политехнизм - Система обучения {Система}
политотделец - Работник политотдела {Работник}
политпросветработник - Работник политпросвета {Работник}
политредактор - редактор см {редактор}
политредакция - редакция см {редакция}
политучёба - Изучение истории {Изучение}
политэкономия - экономия (см {экономия}
полицеймейстер - Начальник полиции {Начальник}
полкирпича - Половина кирпича {Половина}
полковник - командир полка {командир}
полковница - Жена полковника {Жена}
полкруга - Половина круга {Половина}
поллюция - истечение семени {истечение}
полминуты - Половина минуты {Половина}
полмира - Половина мира {Половина}
полновластие - полнота власти {полнота}
полноводье - уровень воды {уровень}
полнокровие - Избыток крови {Избыток}
полнолуние - фаз луны {фаз}
полномера - Половина номера {Половина}
полнота - Состояние чего {Состояние}
полночи - Половина ночи {Половина}
полночь - Середина ночи {Середина}
половодье - Разлив реки {Разлив}
полоз - снегу пластин {снегу}
полоса - кусок чего {кусок}
полотенце - полоса ткани {полоса}
полотно - ткань флага {ткань}
полпорции - Половина порции {Половина}
полпред - представитель СССР {представитель}
полпредство - представительство СССР {представительство}
полпути - Половина пути {Половина}
полслова - Половина слова {Половина}
полсотни - Половина сотни {Половина}
полубак - Палуба бака {Палуба}
полуватт - Половина ватта {Половина}
полугодие - Промежуток времени {Промежуток}
полузащитник - Член команды {Член}
полузнайство - Свойство полузнайки {Свойство}
полуимя - имя какого {имя}
полукольцо - Половина кольца {Половина}
полукруг - Половина круга {Половина}
полулист - Кусок чего {Кусок}
полумесяц - диск луны {диск}
полупар - система обработки {система}
полурота - Половина роты {Половина}
полусфера - Половина сферы {Половина}
полфунта - Половина фунта {Половина}
полцены - Половина цены {Половина}
полчаса - Половина часа {Половина}
полчетверти - Половина четверти {Половина}
полштофа - Половина штофа {Половина}
полюс - точек пересечения {точек}
пом - Помощник какого {Помощник}
помбух - Сокращение слов {Сокращение}
померанец - дерево родом {дерево}
поместье - владение помещика {владение}
помзав - Сокращение слов {Сокращение}
помнач - Сокращение слов {Сокращение}
помология - Теория плодоводства {Теория}
поморы - население побережья {население}
поморяне - Жители поморий {Жители}
помпадурша - Жена помпадура {Жена}
понедельник - дней недели {дней}
пономариха - Жена пономаря {Жена}
понос - Расстройство функции {Расстройство}
понтон - лодка (см {лодка}
попадья - Жена священника {Жена}
попечение - Оказание покровительства {Оказание}
попечительство - Система мероприятий {Система}
поплавок - Кусок пробки {Кусок}
попович - Сын священника {Сын}
поповна - Дочь священника {Дочь}
поприще - Сфера деятельности {Сфера}
пора - Время года {Время}
пораженец - Сторонник пораженчества {Сторонник}
порнограф - Любитель порнографии {Любитель}
порода - животных того {животных}
пороз","порос - Самец свиньи {Самец}
поросятина - Мясо поросенка {Мясо}
поросёнок - Детеныш свиньи {Детеныш}
порошина","порошинка - крупица пороха {крупица}
портянка - Кусок ткани {Кусок}
порубка - рубка леса {рубка}
поручица - Жена поручика {Жена}
порядок - Состояние благоустройства {Состояние}
посадничество - Должность посадника {Должность}
посвист - свист кого {свист}
посечься - Сов к {Сов}
поскачка - Бег борзой {Бег}
посконь - особь конопли {особь}
поскотина - Пастбище выгон {Пастбище}
посланница - Жена посланника {Жена}
постничество - Соблюдение постов {Соблюдение}
постриг - Обряд принятия {Обряд}
потуги - сокращение мышц {сокращение}
похабщина - разговоры ругательства {разговоры}
почвоутомление - Истощение почвы {Истощение}
почесть - выражение уважения {выражение}
почка - Побег растения {Побег}
почтамт - отделение почты {отделение}
почтмейстерша - Жена почтмейстера {Жена}
пощада - Проявление сострадания {Проявление}
поэма - произведение (муз {произведение}
пояс - полоса (тех {полоса}
прабабушка - Мать деда {Мать}
правильщик - Рабочий к {Рабочий}
правленец - Член правления {Член}
правнук - Сын внука {Сын}
правнучка - Дочь внука {Дочь}
право - Совокупность правил {Совокупность}
правозаступничество - Деятельность правозаступника {Деятельность}
правомочие - обладание каким {обладание}
правописание - Система письма {Система}
прадед - Отец деда {Отец}
прадедушка - Ласкат к {Ласкат}
празднество - празднование чего {празднование}
практика - Деятельность врача {Деятельность}
праматерь - Прародительница какого {Прародительница}
праотец - Прародитель родоначальник {Прародитель}
прапрабабушка - Мать прадеда {Мать}
праправнук - Сын правнука {Сын}
праправнука","праправнучка - Дочь правнука {Дочь}
прапрадед - Отец прадеда {Отец}
прародина - место обитания {место}
пращур - Отец прапрадеда {Отец}
пред - Председатель какого {Председатель}
предводительша - Жена предводителя {Жена}
предел - Граница черта {Граница}
предельчество - Практика работы {Практика}
предзнаменование - Примета чего {Примета}
предпарламент - совет республики {совет}
предпринимательство - Деятельность предпринимателя {Деятельность}
предпрядение - Изготовление предпряжи {Изготовление}
председательство - Исполнение обязанностей {Исполнение}
предсердие - отделов сердца {отделов}
представительство - Наличие представителей {Наличие}
презентант - Предъявитель какого {Предъявитель}
президент - Глава государства {Глава}
преизбыток - избыток чего {избыток}
преисподняя - Ад каком {Ад}
прейскурант - Справочник цен {Справочник}
премудрость - мудрость (устар {мудрость}
преобразователь - Реформатор человек {Реформатор}
преосвященный - Титул епископа {Титул}
преосвященство - титулование епископа {титулование}
препаратор - Служащий (какой {Служащий}
преподавательство - Деятельность занятия {Деятельность}
прерафаэлиты - Группа художников {Группа}
пресвитерианство - Исповедание пресвитериан {Исповедание}
пресса - печать газеты {печать}
престол - Трон монарха {Трон}
престолонаследие - Порядок перехода {Порядок}
префектура - Должность префекта {Должность}
префиксация - Употребление префикса {Употребление}
прецессия - передвижение точек {передвижение}
приборостроение - Производство приборов {Производство}
прибрежье - полоса земли {полоса}
прибыль - Доход капиталистов {Доход}
приват-доцент - звание доцента {звание}
приват-доцентура - Должность приват-доцента {Должность}
привидение - Призрак умершего {Призрак}
привычка - Образ действий {Образ}
привязанность - Чувство близости {Чувство}
пригарь - Привкус дыма {Привкус}
приговор - Решение суда {Решение}
придыхание - Звук речи {Звук}
признательность - Чувство благодарности {Чувство}
призёр - Участник состязания {Участник}
приказ - распоряжение судьи {распоряжение}
прилагательность - Ряд признаков {Ряд}
прилёт - Появление где {Появление}
прима - звук тонов {звук}
приманка - Кусок пищи {Кусок}
применяемость - Применение чего {Применение}
пример - образец чего {образец}
примиренчество - Политика примирения {Политика}
принуждённость - Отсутствие простоты {Отсутствие}
приовражье - Участок земли {Участок}
припадок - приступ какой {приступ}
природовед - Преподаватель природоведения {Преподаватель}
прислуга - работница (устар {работница}
приспособленчество - Поведение приспособленца {Поведение}
пристав - Начальник полиции {Начальник}
пристанодержатель - Содержатель притона {Содержатель}
пристяжка - Запряжка лошади {Запряжка}
прихлебательство - Поведение прихлебателя {Поведение}
причащение - обрядов (т {обрядов}
причинность - связи явлений {связи}
причт - Духовенство какой {Духовенство}
пробель - Примесь белизны {Примесь}
пробка - Кора нек {Кора}
пробор - раздел волос {раздел}
проволочина - Кусок проволоки {Кусок}
программа - План (деятельности {План}
прогрессивка - оплата труда {оплата}
прогрессист - Сторонник прогресса {Сторонник}
прогрессия - Ряд чисел {Ряд}
продналог - налог см {налог}
продуктообмен - Система снабжения {Система}
продукция - сумма продуктов {сумма}
проект - план постройки {план}
производительность - Плодотворность продуктивность {Плодотворность}
пройда - делах человек {делах}
проказа - Шалость проделка {Шалость}
прокламация - Провозглашение обнародование {Провозглашение}
проклятие - Выражение кому {Выражение}
проконсульство - Должность проконсула {Должность}
прокурорство - Должность прокурора {Должность}
пролетаризация - Процесс разорения {Процесс}
пролетарий - средств производства {средств}
промульгация - Обнародование какого {Обнародование}
промфинплан - план предприятия {план}
пропаганда - Распространение каких {Распространение}
проповедничество - Деятельность проповедника {Деятельность}
прораб - Сокращение слов {Сокращение}
прорва - русло реки {русло}
проректор - Помощник ректора {Помощник}
прорость - прослойка мяса {прослойка}
прорывщик - вине к {вине}
просветитель - Распространитель знаний {Распространитель}
просинь - Примесь синевы {Примесь}
проскачка - число сбоев {число}
просодия - Система произношения {Система}
просол - Качество засола {Качество}
простак - уму человек {уму}
простата - железа (см {железа}
простатит - Воспаление простаты {Воспаление}
пространство - Состояние материи {Состояние}
протекционизм - система подбора {система}
протекционист - Сторонник протекционизма {Сторонник}
противень - ветер (обл {ветер}
противодавление - Давление пара {Давление}
противостояние - Положение планеты {Положение}
протозоология - Отдел зоологии {Отдел}
протоистория - период жизни {период}
проток - рукав реки {рукав}
протоколизм - стиль изложения {стиль}
протопопица - Жена протопопа {Жена}
профактив - актив См {актив}
профбилет - билет См {билет}
профбюрократ - бюрократ См {бюрократ}
профвредность - Вредность производства {Вредность}
профдвижение - движение См {движение}
профессионалист - Работник профсоюза {Работник}
профессор - звание преподавателей {звание}
профессорство - Занятие профессора {Занятие}
профессорша - Жена профессора {Жена}
профилактика - Совокупность мероприятий {Совокупность}
профком - Сокращение слов {Сокращение}
профобразование - образование См {образование}
профпросвещение - просвещение См {просвещение}
профработа - работа См {работа}
профсобрание - Собрание членов {Собрание}
профсоюз - союз См {союз}
профтехшкола - школа См {школа}
процедура - Порядок выполнения {Порядок}
прудонист - Сторонник прудонизма {Сторонник}
прясло - кольцо гайка {кольцо}
псалтырь - Книга псалмов {Книга}
псина - мясо собаки {мясо}
психиатрия - Отрасль медицины {Отрасль}
психика - организация человека {организация}
психоанализ - Метод исследования {Метод}
психологист - Последователь психологизма {Последователь}
психотерапия - Лечение болезней {Лечение}
психофизиология - Отдел психологии {Отдел}
птенец - Детеныш птицы {Детеныш}
птицеловство - Ловля птиц {Ловля}
пуансовка - Накладывание клейма {Накладывание}
пуантиллизм - манера живописи {манера}
пуговица - бортам одежды {бортам}
пуд - мера веса {мера}
пудлингование - Переработка чугуна {Переработка}
пульверизация - Распыление жидкости {Распыление}
пулька - Партия игры {Партия}
пульпит - Воспаление пульпы {Воспаление}
пульс - движение чего {движение}
пунктуация - Расстановка знаков {Расстановка}
пунсон - изображение литеры {изображение}
пурист - Сторонник пуризма {Сторонник}
пустобрёх - собака (охот {собака}
пустомеля - Болтун человек {Болтун}
пустошовка - Кладка кирпичей {Кладка}
пустошь - участок земли {участок}
пустынножительство - Жизнь пустынножителя {Жизнь}
пустыня - пространство земли {пространство}
пустышка - предмет соска {предмет}
пустяк - обстоятельство что {обстоятельство}
путчизм - Политика путчей {Политика}
путь","путь-дорога - Полоса земли {Полоса}
пушинка - частица пуха {частица}
пушкинизм - Изучение творчества {Изучение}
пушнина - Шкуры животных {Шкуры}
пчеловодство - Разведение пчел {Разведение}
пыж - Скаток шерсти {Скаток}
пылинка - частица пыли {частица}
пытка - насилие истязания {насилие}
пышность - Роскошь великолепие {Роскошь}
пьеза - Единица давления {Единица}
пьеса - произведение (муз {произведение}
пэ - буквы «п {буквы}
пэрство - Звание пэра {Звание}
пядь - мера длины {мера}
пятерня - Ладонь руки {Ладонь}
пятидневка - Период времени {Период}
рабкооп - Сокращение слов {Сокращение}
рабкор - Сокращение слов {Сокращение}
рабочеделец - Сторонник рабочедельства {Сторонник}
рабочий - условиях капитализма {условиях}
рабсила - сила см {сила}
рабфак - Сокращение слов {Сокращение}
рабфаковец - Учащийся рабфака {Учащийся}
раввинат - Собрание раввинов {Собрание}
равновесие - Состояние (какого {Состояние}
рад","рад-радёхонек","рад-радёшенек - чувстве радости {чувстве}
радетель - Покровитель благодетель {Покровитель}
радиан - Единица измерения {Единица}
радиовещание - Передача (речи {Передача}
радиоволна - Волна лучей {Волна}
радиолюбительство - Занятие любителей {Занятие}
радиопередача - Передача чего {Передача}
радиотелеграф - Система передачи {Система}
радиотелеграфирование - Передача сообщений {Передача}
радиотелеграфист - Телеграфист радиотелеграфа {Телеграфист}
радиотелефония - телефония см {телефония}
радиотерапия - Лечение болезней {Лечение}
радиотехника - Отдел электротехники {Отдел}
радиоузел - Орган управления {Орган}
радиофоник - Работник радио {Работник}
радиоцентр - Объединение управления {Объединение}
радиус - точку центра {точку}
радость - Чувство удовольствия {Чувство}
радужина","радужка - оболочка (см {оболочка}
радуница - обычай поминания {обычай}
разбойник - Грабитель человек {Грабитель}
разведёнка - Женщина к {Женщина}
разгильдяй - делах человек {делах}
разгильдяйство - Поведение разгильдяя {Поведение}
раздельнополость - Разделение полов {Разделение}
раздумье - Состояние сосредоточенности {Состояние}
разлад - Отсутствие порядка {Отсутствие}
размер - Величина какого {Величина}
разновидность - Группа особей {Группа}
разноспоровые - Группа растений {Группа}
разрядка - расстановка букв {расстановка}
райком - Сокращение слов {Сокращение}
районирование - разделение страны {разделение}
райсовет - совет (см {совет}
ракита - нек растений {нек}
расист - Сторонник расизма {Сторонник}
расклад - Положение чего {Положение}
распорядок - организация какого {организация}
распутица - Время кода {Время}
распутство - образ жизни {образ}
рассвет - Время суток {Время}
расстрига - Служитель культа {Служитель}
рассуждение - Ряд мыслей {Ряд}
растворимость - Способность вещества {Способность}
растительность - Совокупность растений {Совокупность}
ратман - член органа {член}
раунд - промежуток времени {промежуток}
рафия - Порода пальм {Порода}
рахитизм - Совокупность признаков {Совокупность}
рационализация - Организация какой {Организация}
рационалист - Последователь рационализма {Последователь}
рвота - извержение содержимого {извержение}
реактор - Катушка самоиндукции {Катушка}
ребро - кость пересечения {кость}
реверс - сторона медали {сторона}
реверсирование - Изменение направления {Изменение}
реверсия - Возврат имущества {Возврат}
ревизионист - Последователь ревизионизма {Последователь}
ревизия - Обследование деятельности {Обследование}
ревматизм - Болезнь суставов {Болезнь}
регенерация - Нагрев газа {Нагрев}
регент - Правитель государства {Правитель}
регентство - правление Франции {правление}
регистр - Список чего {Список}
регрессат - Лицо к {Лицо}
регуляция - Стремление организма {Стремление}
редакторство - Деятельность редактора {Деятельность}
редколлегия - коллегия см {коллегия}
редупликация - способов словообразования {способов}
резак - нож (обл {нож}
резекция - Операция удаления {Операция}
резидент - представитель государства {представитель}
резиденция - Местопребывание правительства {Местопребывание}
резинка - Кусочек резины {Кусочек}
резник - Мясник (обл {Мясник}
рейдовик - Участник рейда {Участник}
рекрутка - Жена рекрута {Жена}
ректификатор - Аппарат ля {Аппарат}
ректорство - Должность ректора {Должность}
рекуперация - Восстановление вещества {Восстановление}
рель - участок земли {участок}
релятивизм - учение Эйнштейна {учение}
релятивист - Последователь «принципа {Последователь}
ремедиум - предел уклонения {предел}
ремень - полоса кожи {полоса}
ремилитаризация - Введение войск {Введение}
ремиссия - Ослабление симптомов {Ослабление}
ремнецветные - Семейство растений {Семейство}
рената - Гарнитура шрифтов {Гарнитура}
рентгенология - Отдел медицины {Отдел}
реоскоп - лапка лягушки {лапка}
репертуар - Совокупность ролей {Совокупность}
репетиторство - Занятия репетитора {Занятия}
репина - штука репы {штука}
репняк - Ботва репы {Ботва}
репрезентант - Представитель кого {Представитель}
репрезентация - Представительство кого {Представительство}
репродукция - Воспроизведение того {Воспроизведение}
рескрипт - Письмо монарха {Письмо}
реторсия - Меры воздействия {Меры}
ретушь - Обработка камня {Обработка}
рефлексия - Отражение света {Отражение}
реформист - Сторонник реформизма {Сторонник}
рецензент - Автор рецензии {Автор}
рецепт - указание врача {указание}
рецептар - Служащий аптеки {Служащий}
решаемость - Возможность решения {Возможность}
решетина - брус решетника {брус}
реэмиграция - возвращение эмигрантов {возвращение}
ржавость - Наличие ржавчины {Наличие}
ржанец - Спорынья нек {Спорынья}
ржание - Крик лошади {Крик}
риза - облачение священника {облачение}
ритм - чередование каких {чередование}
ритуал - порядок совершения {порядок}
рифление - Обработка поверхности {Обработка}
рифмоплёт - сочинитель стихов {сочинитель}
рифмоплётство - Занятие рифмоплета {Занятие}
ровница - лента пряжи {лента}
рогаль - Рукоятка сохи {Рукоятка}
роговица - оболочка глаза {оболочка}
родины - Празднование рождения {Празднование}
родич - Член рода {Член}
родня - Родственники родственница {Родственники}
родословие - Преемство поколений {Преемство}
роды - процесс рождения {процесс}
рожа - Лицо (простореч {Лицо}
рождаемость - Количество рождений {Количество}
розан - Цветок розы {Цветок}
розваль - -н предметов {-н}
розница - Продажа чего {Продажа}
ройба - Роение времени {Роение}
рокайль - мотив обломков {мотив}
романтик - Сторонник романтизма {Сторонник}
ропата","ропать - домов (кирок {домов}
росинка - Капля росы {Капля}
росплывь - Способ сплава {Способ}
ростовщичество - Занятие ростовщика {Занятие}
росток - Стебель растения {Стебель}
ротмистрша - Жена ротмистра {Жена}
роялист - Сторонник роялизма {Сторонник}
рубрика - Заголовок раздела {Заголовок}
ругань - Слова к {Слова}
рука - конечностей обезьяны {конечностей}
руководительство - Деятельность руководителя {Деятельность}
руло","рулон - сверток бумаги {сверток}
румянец - цвет лица {цвет}
руно - Шерсть овцы {Шерсть}
русачина - Увелич к {Увелич}
руссоизм - Система взглядов {Система}
руссофил - Сторонник политики {Сторонник}
руссофильство - Образ мыслей {Образ}
руссофоб - Противник политики {Противник}
руссофобство - Образ мыслей {Образ}
ручей - поток воды {поток}
рцы - буквы «р {буквы}
рыбец - Порода рыбы {Порода}
рыбица - Ласкат к {Ласкат}
рыбища - Увелич к {Увелич}
рыбник - Продавец рыбы {Продавец}
рыбоводство - разведение рыбы {разведение}
рыболовство - Ловля рыбы {Ловля}
рывок - движение тяжести {движение}
рыдван - карета (старин {карета}
рыжуха - Кличка коровы {Кличка}
рысиха - Самка рыси {Самка}
рысца - рысь (см {рысь}
рысёнок - Детеныш рыси {Детеныш}
рыхляк - камень (обл {камень}
рыцарство - сословие эпохи {сословие}
рябь - поверхность пестроты {поверхность}
ряд - Совокупность явлений {Совокупность}
рёв - крик животного {крик}
сабеизм - религия нек {религия}
саботаж - исполнение обязанностей {исполнение}
саботажничество - Действия саботажника {Действия}
сад - Участок земли {Участок}
сазанина - Мясо сазана {Мясо}
салазки - санки (тех {санки}
салицилка - натр (см {натр}
салоп - пальто (истор {пальто}
самбук - Бузина (бот {Бузина}
самовнушение - Внушение чего {Внушение}
самовозбуждение - возбуждение чего {возбуждение}
самоволие - Образ действий {Образ}
самогонокурение - производство самогона {производство}
самодеятельность - Проявление инициативы {Проявление}
самодурство - Образ действия {Образ}
самоеды - ненцев группы {ненцев}
самозабвение - степень возбужденности {степень}
самозаготовка - Заготовка сырья {Заготовка}
самокрутка - воли родителей {воли}
самокрутка - Папироска цыгарка {Папироска}
самолётостроение - Производство самолетов {Производство}
самообразование - Приобретение знаний {Приобретение}
самообслуживание - Обслуживание себя {Обслуживание}
самоокупаемость - Способ ведения {Способ}
самоопыление - цветками растений {цветками}
самосмазка - смазка (машин {смазка}
самосогревание - возникновение тепла {возникновение}
самосожжение - сожжение себя {сожжение}
самосплав - Сплав леса {Сплав}
самотёк - Движение воды {Движение}
самоубийство - лишение себя {лишение}
самоход - движение какой {движение}
санврач - врач См {врач}
сандвич - ломтика хлеба {ломтика}
санкция - Признание законности {Признание}
санчасть - Сокращение слов {Сокращение}
сапожок - сапог (см {сапог}
сатанизм - Культ сатаны {Культ}
сателлит - Спутник планеты {Спутник}
сатириаз","сатириазис - возбудимость мужчины {возбудимость}
сатирик - Автор сатир {Автор}
сатурация - Насыщение жидкости {Насыщение}
сахарин - порошок (продукт {порошок}
сахароварение - Процесс получения {Процесс}
сбир - инквизиции (истор {инквизиции}
сбитенщик - Продавец сбитня {Продавец}
сбой - Голова ноги {Голова}
свадебка - Ласкат к {Ласкат}
свариваемость - Свойство металлов {Свойство}
свекловодство - Разведение свеклы {Разведение}
свеклоуборка - Уборка свеклы {Уборка}
свеклоутомление - понижение урожая {понижение}
свекровь - Мать мужа {Мать}
сверхкомплект - люди лошади {люди}
сверхчеловек - философии Ницше {философии}
светобоязнь - чувствительность глаза {чувствительность}
светометрия - Определение местоположения {Определение}
светосила - Интенсивность источника {Интенсивность}
светотехника - Отрасль техники {Отрасль}
свивальник - полоса ткани {полоса}
свидетельство - Показание лица {Показание}
свиноводство - Разведение свиней {Разведение}
свистопляска - проявление чего {проявление}
свистун - Любитель свистеть {Любитель}
свиток - полоса бумаги {полоса}
свобода - Возможность проявления {Возможность}
свойлачивание - Процесс образования {Процесс}
свойство - Отношение близости {Отношение}
свояк - Муж свояченицы {Муж}
свояченица - Сестра жены {Сестра}
связист - Работник связи {Работник}
связь - -н учреждений {-н}
святошество - Поведение святоши {Поведение}
святыня - предмет поклонения {предмет}
свёкор - Отец мужа {Отец}
сгнёток - комок чего {комок}
сговорённость - Наличие соглашения {Наличие}
сгружать - Несов к {Несов}
себестоимость - Сумма затрат {Сумма}
север - стран страны {стран}
севок - Горсть зерна {Горсть}
севооборот - Система полеводства {Система}
севосмен - Система чередования {Система}
севрюжина - Мясо севрюги {Мясо}
сегментация - строение организма {строение}
сезон - времен года {времен}
сеид - титул лиц {титул}
сейм - собрания парламента {собрания}
сеймик - собрание шляхты {собрание}
сейнер - судно типа {судно}
сейсмограмма - Запись колебаний {Запись}
сейсмография - Запись колебаний {Запись}
сейсмология - Отдел геологии {Отдел}
секанс - функция угла {функция}
секретариат - Совокупность лиц {Совокупность}
секретарство - Обязанности секретаря {Обязанности}
секретарша - Женщина секретаря {Женщина}
секреция - Процесс выработки {Процесс}
сектант - Последователь какой {Последователь}
секуляризация - Изъятие чего {Изъятие}
секунд-майор - чин капитана {чин}
секунда - Единица времени {Единица}
секционер - Член какой {Член}
селезень - Самец утки {Самец}
селекция - Улучшение сорта {Улучшение}
селенография - Отдел астрономии {Отдел}
сельдевые - Семейство рыб {Семейство}
селькор - Сокращение слов {Сокращение}
сельмаг - Сокращение слов {Сокращение}
сельсовет - совет власти {совет}
сельсоветчик - Работник сельсовета {Работник}
селямлик - шествие султана {шествие}
семасиология - Отдел лингвистики {Отдел}
семеноводство - Отрасль хозяйства {Отрасль}
семидесятник - деятель 70-х {деятель}
семидневка - Единица времени {Единица}
семизвездие - звезд Плеяды {звезд}
семинарист - Ученик семинарии {Ученик}
семиотика - Распознавание болезней {Распознавание}
семиполье - Система плодосмена {Система}
семитизм - Оборот речи {Оборот}
семитология - Цикл наук {Цикл}
семиты - Группа народов {Группа}
семссуда - ссуда зерна {ссуда}
семфонд - фонд См {фонд}
семья - Группа людей {Группа}
семя - Орган размножения {Орган}
семяпочка - Зародыш семени {Зародыш}
сенатор - Член сената {Член}
сенаторша - Жена сенатора {Жена}
сенозаготовка - Заготовка сена {Заготовка}
сенокос - Косьба травы {Косьба}
сеностав - Уборка сена {Уборка}
сеноуборка - Уборка сена {Уборка}
сенсибилизация - Возбуждение чувствительности {Возбуждение}
сенсимонист - Последователь сенсимонизма {Последователь}
сенсуалист - Последователь сенсуализма {Последователь}
сентиментализм - направление конца {направление}
сенцо - Ласкат к {Ласкат}
сеньорен-конвент - Совет лидеров {Совет}
сепсис - заражение организма {заражение}
сераль - странах Востока {странах}
сервиз - комплект столовой {комплект}
сервис - Совокупность учреждений {Совокупность}
сердце - орган кровообращения {орган}
сердцебиение - биение сердца {биение}
серенада - поэзии трубадуров {поэзии}
серка","серко - Кличка лошади {Кличка}
серотерапия - Лечение болезней {Лечение}
серповище - Рукоятка серпа {Рукоятка}
серсо - Игра в {Игра}
серум - Сыворотка крови {Сыворотка}
сетка - отделов желудка {отделов}
сеттер - легавой собаки {легавой}
сетчатокрылые - Отряд насекомых {Отряд}
сибаритство - Образ жизни {Образ}
сигнарант - Работник аптеки {Работник}
сиговина - Мясо сига {Мясо}
сигуранца - полиции охранки {полиции}
сидельчиха - Жена сидельца {Жена}
сизарь - голубь родоначальник {голубь}
сила - Способность проявления {Способность}
силища - Увелич к {Увелич}
силуэт - изображение человека {изображение}
симония - Система замещения {Система}
синдесмология - Отдел анатомии {Отдел}
синедрион - Совет старейшин {Совет}
синкретист - Сторонник синкретизма {Сторонник}
синология - Совокупность наук {Совокупность}
синонимика - Отдел лексикологии {Отдел}
синонимия - Одинаковость слов {Одинаковость}
синопсис - Сборник статей {Сборник}
синтагма - Cочетание слов {Cочетание}
синтаксис - Отдел грамматики {Отдел}
синтез - Метод исследования {Метод}
синтетика - Метод исследования {Метод}
синус - пазух углублений {пазух}
синус - функция угла {функция}
сипота - состояние сухости {состояние}
сироп - отвар фруктов {отвар}
сиротство - Состояние сироты {Состояние}
ситовина - Болезнь древесины {Болезнь}
ситуация - Совокупность обстоятельств {Совокупность}
сифилидология - Отрасль медицины {Отрасль}
сказатель - Автор сказания {Автор}
сказуемое - членов предложения {членов}
сказуемость - Свойство сказуемого {Свойство}
скалозубые - Семейство рыб {Семейство}
скандинавцы","скандинавы - Группа народов {Группа}
скатерть - Кусок ткани {Кусок}
скважность - Наличие скважин {Наличие}
скворка - Самка скворца {Самка}
скелет - Совокупность костей {Совокупность}
скептик - Сторонник скептицизма {Сторонник}
скирд","скирда - стог сена {стог}
скирдоправ - Укладчик соломы {Укладчик}
скитальчество - образ жизни {образ}
склад - Запас чего {Запас}
складка - Полоса ткани {Полоса}
склеп - Место погребения {Место}
склероз - процесс отвердения {процесс}
скованность - Отсутствие свободы {Отсутствие}
сколок - кусок чего {кусок}
скопчество - Состояние скопца {Состояние}
скоропашка - орудие род {орудие}
скорость - степень увеличения {степень}
скосок - клин (ткани {клин}
скотоводство - Разведение скота {Разведение}
скотозаготовки - Заготовка скота {Заготовка}
скотоподобие - Образ жизни {Образ}
скотопромышленник - Работник скотопромышленности {Работник}
скотопромышленность - Отрасль хозяйства {Отрасль}
скрута - Сборы приготовления {Сборы}
скряжничество - Поведение скряги {Поведение}
скудоумие - Слабость ума {Слабость}
скуловорот - Повреждение скулы {Повреждение}
скульптура - Искусство изготовления {Искусство}
слабогрудость - Слабость груди {Слабость}
славолюбие - Желание славы {Желание}
славословие - Прославление бога {Прославление}
славяне - Группа народов {Группа}
славяноведение - Совокупность дисциплин {Совокупность}
славянофил - Приверженец славянофильства {Приверженец}
славянофобство - Образ мыслей {Образ}
слепота - Отсутствие зрения {Отсутствие}
слесарша - Жена слесаря {Жена}
слизевик - растение клетки {растение}
слизень - нек моллюсков {нек}
слизетечение - Выделение слизи {Выделение}
слобожанин - Житель слободы {Житель}
словарик - Словарь (см {Словарь}
словник - Список слов {Список}
слово - Единица речи {Единица}
словоизменение - изменение слов {изменение}
словолитчик - Рабочий словолитни {Рабочий}
словосочинение - связь слов {связь}
словцо - Слово (см {Слово}
сложа - Дееприч прош {Дееприч}
слониха - Самка слона {Самка}
слонёнок - Детеныш слона {Детеныш}
слухач - Служащий радиосвязи {Служащий}
слышимость - степень отчетливости {степень}
слюнотечение - выделение слюны {выделение}
смальта - краска бумаги {краска}
смертничество - Состояние обречения {Состояние}
смертность - Количество смертей {Количество}
смерть - Прекращение жизни {Прекращение}
смерч - движение воздуха {движение}
смесь - стройности единства {стройности}
смоква - Плод смоковницы {Плод}
смолокурение - Добывание смолы {Добывание}
смородинник - Кусты смородины {Кусты}
смотр - освидетельствование чего {освидетельствование}
смотрины - обряд знакомства {обряд}
смотрительша - Жена смотрителя {Жена}
смысл - содержание (слова {содержание}
смётки - Остатки чего {Остатки}
снабженец - Работник органов {Работник}
снегозадержание - задерживание снега {задерживание}
снегоочистка - Расчистка пути {Расчистка}
снегопад - Выпадение снега {Выпадение}
снеготаяние - Таяние снега {Таяние}
снегурочка - образ девушки {образ}
снежинка - кристаллик снега {кристаллик}
сноп - пук колосьев {пук}
снос - платье обуви {платье}
сноха - Жена сына {Жена}
снохачество - сожительство свекра {сожительство}
собачник - Любитель собак {Любитель}
собеседник - Участник беседы {Участник}
собирательство - Деятельность собирателя {Деятельность}
соболеводство - Разведение соболей {Разведение}
соболезнование - Сочувствие чувства {Сочувствие}
соболюшка - Самка соболя {Самка}
соболёнок - Детеныш соболя {Детеныш}
соборование - наз таинств {наз}
соборянин - Служитель культа {Служитель}
собственник - Владелец какой {Владелец}
совнарком - Сокращение слов {Сокращение}
совработник - работник (см {работник}
совсод - Совет содействия {Совет}
совёнок - Птенец совы {Птенец}
содоклад - доклад какого {доклад}
сожаление - Чувство печали {Чувство}
созвездие - Группа звезд {Группа}
соискатель - Участник конкурса {Участник}
соколиха - Самка сокола {Самка}
соколок - ноге лошади {ноге}
соколёнок - Детеныш сокола {Детеныш}
солдатчина - набор (истор {набор}
солеварение - Выварка соли {Выварка}
солеломня - Место выработки {Место}
солидарность - сочувствие каким {сочувствие}
солипсист - Последователь солипсизма {Последователь}
солитер - брильянта (мин {брильянта}
солнце - светило ком {светило}
соловка - Самка соловья {Самка}
соловьиха - Самка соловья {Самка}
соловьёнок - Птенец соловья {Птенец}
соломина - стебель соломы {стебель}
сомовина - Мясо сома {Мясо}
сон - состояние покоя {состояние}
сопливец - человек (пренебр {человек}
соринка - кусочек чего {кусочек}
сорит - цепи силлогизмов {цепи}
сорока - убор род {убор}
сорокалетие - Промежуток времени {Промежуток}
сороконожка - разг речи {разг}
сорочины - день смерти {день}
сорт - разряд род {разряд}
сортимент - Совокупность предметов {Совокупность}
сортоиспытание - Определение сорта {Определение}
состав - Совокупность людей {Совокупность}
составитель - Автор человек {Автор}
состязание - соревнование сторон {соревнование}
сосун - Детеныш млекопитающего {Детеныш}
сотка - сотая ведра {сотая}
сотник - чин поручика {чин}
сотничиха - Жена сотника {Жена}
сотоварищ - Товарищ чей {Товарищ}
социал-демократ - Сторонник социал-демократии {Сторонник}
социал-предательство - Деятельность социал {Деятельность}
социализм - фаза коммунизма {фаза}
социалист - Сторонник социализма {Сторонник}
соцсовместитель - Рабочий к {Рабочий}
соцсовместительство - Работа соцсовместителя {Работа}
соцстрах - Сокращение слов {Сокращение}
союз - единение предложений {единение}
спазм","спазма - сжатие мышц {сжатие}
спектрометрия - Измерение длины {Измерение}
спектроскопия - Исследование спектров {Исследование}
спец - Сокращение слова {Сокращение}
спецификум - особенность чего {особенность}
спикер - Наименование председателя {Наименование}
спиннинг - Способ ужения {Способ}
спираль - Спертость воздуха {Спертость}
список - -н сведения {-н}
сплавщик - сплавкой металлов {сплавкой}
спланхнология - Отдел анатомии {Отдел}
спокойствие - Отсутствие волнения {Отсутствие}
сполье - Смежность полей {Смежность}
спор - Скопление чего {Скопление}
спорок - верх платья {верх}
спортивки - Легкие туфли {Легкие}
споруляция - Процесс образования {Процесс}
спрингер - легавой собаки {легавой}
спрут - животное класса {животное}
спрыск - Наконечник брандспойта {Наконечник}
спурт - усиление хода {усиление}
сравнимость - Возможность сравнения {Возможность}
сражение - столкновение войск {столкновение}
срок - промежуток времени {промежуток}
срубщик - срубом (см {срубом}
ссыпщик - Сдатчик зерна {Сдатчик}
ставка - Место расположения {Место}
ставленник - Кандидат (старин {Кандидат}
стадий - мера длины {мера}
стадо - Группа животных {Группа}
стаж - Срок службы {Срок}
сталинец - Последователь учения {Последователь}
стан - Место расположения {Место}
стан - Туловище одежды {Туловище}
стандартизация - Рационализация производства {Рационализация}
станиоль - лист олова {лист}
становище - Место стоянки {Место}
станция - Пункт остановки {Пункт}
старейшинство - Звание обязанности {Звание}
староречье - русло реки {русло}
старостиха - Жена старосты {Жена}
старость - Период жизни {Период}
старт - Момент вступления {Момент}
старьё - употреблении вещи {употреблении}
статс-дама - звание женщины {звание}
стачкист - Сторонник стачкизма {Сторонник}
створка - половинок (ворот {половинок}
стекловарение - Приготовление стекломассы {Приготовление}
стеклоделие - Производство стекла {Производство}
стеллаж - сделка курсов {сделка}
стеллаж - Ряд полок {Ряд}
стеллит - сплав кобальта {сплав}
стельность - Состояние беременности {Состояние}
стен - Единица силы {Единица}
стендист - Работник выставки {Работник}
стенография - Способ письма {Способ}
стеноз - Сужение каналов {Сужение}
стенокардия - Болезнь сердца {Болезнь}
стерва - Труп животного {Труп}
стереография - изображение поверхности {изображение}
стереорама - Панорама (см {Панорама}
стереотипия - Способ печатания {Способ}
стерляжина - Мясо стерляди {Мясо}
стихосложение - Система построения {Система}
стихотворство - Писание стихов {Писание}
стланец - Солома (треста {Солома}
стоглав - сборник середины {сборник}
стоик - Последователь философии {Последователь}
стойка - Положение тела {Положение}
столетник - растений алоэ {растений}
столица - город государства {город}
столишка - стол (см {стол}
столпничество - подвижничества (см {подвижничества}
столяриха - Жена столяра {Жена}
стоматология - Отдел медицины {Отдел}
стопка - кучка предметов {кучка}
сторожиха - Жена сторожа {Жена}
сторонник - Последователь каких {Последователь}
странгуляция - Защемление (напр {Защемление}
страница - сторона листа {сторона}
стратегия - Искусство ведения {Искусство}
стратосфера - слой атмосферы {слой}
стрельбище - участок земли {участок}
стрельчиха - Жена стрельца {Жена}
стренга - Прядь каната {Прядь}
стрепетёнок - Детеныш стрепета {Детеныш}
стреха - край крыши {край}
строй - Ряд предметов {Ряд}
строка - Ряд слов {Ряд}
стропилина - брус стропила {брус}
строфант - растение (бот {растение}
строчок - Гриб род {Гриб}
струп - корочка сыпи {корочка}
стручок - нек растений {нек}
струя - поток воздуха {поток}
студист - Ученик студии {Ученик}
студия - Мастерская художника {Мастерская}
стыд - Чувство смущения {Чувство}
суббота - воскресеньем дня {воскресеньем}
субвенция - пособие государства {пособие}
сублимат - Продукт сублимации {Продукт}
сублимация - Переход вещества {Переход}
субстрат - основе чего {основе}
судаковина - Мясо судака {Мясо}
судебник - Собрание законов {Собрание}
судоремонт - Ремонт судов {Ремонт}
судорога - сведение мышц {сведение}
судоходство - Плавание судов {Плавание}
судьба - Стечение обстоятельств {Стечение}
судёнышко - судно (см {судно}
сук - отросток ствола {отросток}
суконка - Лоскут сукна {Лоскут}
султан - Титул монарха {Титул}
султанат - Власть султана {Власть}
султанчик - султан (см {султан}
султанша - Жена султана {Жена}
сульфид - соединений серы {соединений}
сумасшествие - Потеря рассудка {Потеря}
сумбур - Отсутствие ясности {Отсутствие}
сунна - Собрание преданий {Собрание}
супоросость","супоросность - Состояние беременности {Состояние}
сурдопедагогика - Методика преподавания {Методика}
сустав - сочленение (см {сочленение}
сутенёр - Любовник проститутки {Любовник}
сутки - Единица времени {Единица}
суфлёр - Работник театра {Работник}
суфражистка - Сторонница суфражизма {Сторонница}
суффиксация - Образование слов {Образование}
сухарь - кусок хлеба {кусок}
сушь - разг обл {разг}
сущность - содержание свойства {содержание}
сценарист - Автор сценария {Автор}
счастье - Состояние довольства {Состояние}
счетоводство - Ведение учета {Ведение}
считчик - Работник издательства {Работник}
сынище - Увелич к {Увелич}
сыроварение - Изготовление сыра {Изготовление}
сыропуст - день масленицы {день}
сычонок - Птенец сыча {Птенец}
сычуг - отделов желудка {отделов}
сэт - Партия игры {Партия}
сюжет - Совокупность действий {Совокупность}
сюзерен - эпоху феодализма {эпоху}
сюзеренитет - право сюзерена {право}
сёмжина - Мясо семги {Мясо}
табаководство - Разведение табака {Разведение}
табельщик - Работник предприятия {Работник}
таблица - Перечень чего {Перечень}
табулатура - Система указания {Система}
табун - Стадо лошадей {Стадо}
тавлинцы - Горцы Дагестана {Горцы}
тайнобрачие - Способ размножения {Способ}
такса - органами власти {органами}
таксация - Установление таксы {Установление}
таксиметрия - Определение скорости {Определение}
такт - единица (ноты {единица}
такт - Чувство меры {Чувство}
тактика - Искусство ведения {Искусство}
тали - Система блоков {Система}
талия - колоды карт {колоды}
талмуд - Свод правил {Свод}
тальвег - место рельефа {место}
тамада - Распорядитель пира {Распорядитель}
таможенник - Служащий таможни {Служащий}
тампон - Кусочек ваты {Кусочек}
тампонация - Вставление тампона {Вставление}
тангенс - функция угла {функция}
танин - коры растений {коры}
танцкласс - Школа танцев {Школа}
танцмейстер - Учитель танцев {Учитель}
тапочки - Легкие туфли {Легкие}
тарань - рыба род {рыба}
тарификация - Определение тарифа {Определение}
тартание - Добыча нефти {Добыча}
татары - народностей Кавказа {народностей}
тафья - шапочка род {шапочка}
тахикардия - ускорение работы {ускорение}
твердо - буквы «т {буквы}
театрал - Любитель театра {Любитель}
театрализация - Приспособление чего {Приспособление}
тебенёк - лопасть седла {лопасть}
тезаврирование - Сбережение (денег {Сбережение}
тезоименитство - Именины (какого {Именины}
теист - Последователь теизма {Последователь}
текинцы - племя туркмен {племя}
текстиль - Ткани изделия {Ткани}
текстология - Отрасль филологии {Отрасль}
тектоника - Отдел геологии {Отдел}
телевещание - Передача изображений {Передача}
телеграфист - Работник телеграфа {Работник}
телекино - Передача кинофильмов {Передача}
телеса - тело толстяка {тело}
телефонист - Работник телефона {Работник}
телодвижение - Движение тела {Движение}
телосложение - Сложение тела {Сложение}
телятина - Мясо теленка {Мясо}
телятки - Ласкат к {Ласкат}
телятник - Хлев закута {Хлев}
телёнок - Детеныш нек {Детеныш}
тема - Предмет какого {Предмет}
темп - Степень скорости {Степень}
температура - Степень теплоты {Степень}
темперация - установление высоты {установление}
тендем - Расположение каких {Расположение}
теогония - Совокупность мифов {Совокупность}
теолог - Богослов человек {Богослов}
теософ - Последователь теософии {Последователь}
теплопередача - Передача теплоты {Передача}
теплопроводность - Свойство тел {Свойство}
теплопрозрачность - Способность тела {Способность}
теплотехника - Отдел техники {Отдел}
теплоёмкость - Количество тепла {Количество}
терминология - Совокупность терминов {Совокупность}
термохимия - Отдел химии {Отдел}
терние - растение растения {растение}
терция - ступень к {ступень}
тесина - доска теса {доска}
теситура - Расположение звуков {Расположение}
тесть - Отец жены {Отец}
тетерка - Самка тетерева {Самка}
тетрарх - Правитель тетрархии {Правитель}
техминимум - минимум (см {минимум}
техника - Совокупность приемов {Совокупность}
техничка - служащая (см {служащая}
технология - Совокупность процессов {Совокупность}
технорук - руководитель (см {руководитель}
техперсонал - персонал (см {персонал}
техпропаганда - Пропаганда техники {Пропаганда}
техред - Сокращение слов {Сокращение}
течь - Проникновение воды {Проникновение}
тигрица - Самка тигра {Самка}
тигрёнок - Детеныш тигра {Детеныш}
типаж - Совокупность признаков {Совокупность}
типограф - делом типографии {делом}
типографщик - Работник типографии {Работник}
тирада - отрывок монолога {отрывок}
тирания - Правление тирана {Правление}
тире - Знак пунктуации {Знак}
тиснение - Выдавливание каких {Выдавливание}
титан - греч мифологии {греч}
тифлопедагогика - Методика преподавания {Методика}
тиходом - Домосед человек {Домосед}
тишина - Отсутствие шума {Отсутствие}
тканина - Кусок ткани {Кусок}
товар - Продукт труда {Продукт}
товарищ - Человек к {Человек}
толмач - Переводчик (старин {Переводчик}
толпа - скопление чего {скопление}
толстовец - Последователь толстовства {Последователь}
толстовство","толстовщина - учение писателя {учение}
толща - Массив какого {Массив}
том - Отдел какого {Отдел}
томпак - Сплав меди {Сплав}
тоника - тон гаммы {тон}
тонна - нек мер {нек}
тонус - степень жизнедеятельности {степень}
топография - отдел пунктов {отдел}
топорище - Рукоятка топора {Рукоятка}
топтимберс - ребро остова {ребро}
топчак - привода (см {привода}
торба - Мешок сума {Мешок}
торгашество - Занятие торгаша {Занятие}
торгпред - представитель СССР {представитель}
торгпредство - представительство СССР {представительство}
тореадор - бое быков {бое}
торжественник - сборник житий {сборник}
торпедометание - Сбрасывание торпед {Сбрасывание}
торс - Туловище статуи {Туловище}
торфоразработки - Место добычи {Место}
торфяник - Залежь торфа {Залежь}
тост - пожелание кому {пожелание}
тотем - верованиях нек {верованиях}
тотемизм - культ тотемов {культ}
травести - роль мужчины {роль}
травина - стебель травы {стебель}
травинка - стебелек травы {стебелек}
травма - Повреждение тканей {Повреждение}
травополье - Система полеводства {Система}
травосмесь - Смесь семян {Смесь}
травостой - покров лугов {покров}
траектория - Путь движения {Путь}
трактирщик - Хозяин трактира {Хозяин}
тракторизация - Введение тракторов {Введение}
тракторист - Водитель трактора {Водитель}
транскрипция - Изображение (букв {Изображение}
трансляция - Передача звуков {Передача}
трансплантат - Кусок ткани {Кусок}
трансплантация - Пересадка тканей {Пересадка}
транспортник - Работник транспорта {Работник}
трансфер","трансферт - Перевод денег {Перевод}
трансформация - Перемена вида {Перемена}
трансфузия - Переливание крови {Переливание}
трасса - Чертеж местности {Чертеж}
траур - Состояние скорби {Состояние}
трахома - заболевание конъюнктивы {заболевание}
тред-юнионист - Последователь тред-юнионизма {Последователь}
трензелька - Цепочка трензеля {Цепочка}
трепанация - операция пробуравливания {операция}
трестовик - Работник треста {Работник}
третник - Треть какой {Треть}
триангуляция - Вычисление длины {Вычисление}
тригонометрия - Отдел геометрии {Отдел}
трипсин - Вещество сока {Вещество}
троеженство - Вступление мужчины {Вступление}
тромбоз - Образование тромбов {Образование}
тромбофлебит - Воспаление вен {Воспаление}
тростина - Стебель тростника {Стебель}
троцкизм - агентура буржуазии {агентура}
троцкист - Враг народа {Враг}
труд - деятельность человека {деятельность}
трудодень - Единица учета {Единица}
труп - тело человека {тело}
труппа - Коллектив актеров {Коллектив}
трусильщик - Рабочий к {Рабочий}
трюм - помещение корабля {помещение}
тряпка - Лоскут какой {Лоскут}
трясучка - Лихорадка (обл {Лихорадка}
трёхполье - Система полеводства {Система}
трёшница - бумажка рубля {бумажка}
туловище - Тело человека {Тело}
туман - состояние воздуха {состояние}
туманность - Скопление тумана {Скопление}
тур - круг танца {круг}
туркофил - Сторонник политики {Сторонник}
туркофильство - Образ мыслей {Образ}
туркофоб - Противник политики {Противник}
туркофобство - Образ мыслей {Образ}
турне - путешествие артистов {путешествие}
турнир - состязание (истор {состязание}
турнюр","турнюра - модах конца {модах}
турухтан - Птица род {Птица}
тухлятина - запахом продукт {запахом}
туше - Манера прикосновения {Манера}
тыртыр - Гусеница бабочки {Гусеница}
тысячелетие - Период времени {Период}
тьма - тысяч (старин {тысяч}
тьма - Отсутствие света {Отсутствие}
тэ - буквы «т {буквы}
тэйлоризм - система организации {система}
тюк - сверток товара {сверток}
тюленина - Мясо тюленя {Мясо}
тюленёнок - Детеныш тюленя {Детеныш}
тюрки - группа народов {группа}
тягло - обложение (истор {обложение}
тёлка - Детеныш коровы {Детеныш}
тётенька - Ласкат к {Ласкат}
тётка - Сестра отца {Сестра}
тёща - Мать жены {Мать}
убранство - украшением чего {украшением}
уважение - Чувство почтения {Чувство}
угар - газ самозабвения {газ}
углекислота - Двуокись углерода {Двуокись}
уголёк - кусок угля {кусок}
угорье - Подножие горы {Подножие}
угро-финны - Группа народов {Группа}
угры - Группа угро {Группа}
угрёвина - Мясо угря {Мясо}
угрёнок - угорь (см {угорь}
уд - Член тела {Член}
удалённость - Дальность расстояния {Дальность}
ударение - Выделение (слога {Выделение}
ударничество - Движение ударников {Движение}
удила - ремням узды {ремням}
удовольствие - Чувство радости {Чувство}
удой - Количество молока {Количество}
удойность - Количество удоя {Количество}
ужак - ужа т {ужа}
ужин - Прием пищи {Прием}
ужонок","ужоныш - Детеныш ужа {Детеныш}
узел - Место стебля {Место}
узел - мера скорости {мера}
узина - ширина чего {ширина}
уклад - Устройство чего {Устройство}
уклонизм - Политика уклонов {Политика}
украина - республики (УССР {республики}
укрывательство - сокрытие преступника {сокрытие}
улика - доказательством виновности {доказательством}
улитка - моллюск моллюсков {моллюск}
уловитель - аппаратов приспособлений {аппаратов}
улус - Становище кочевников {Становище}
улыбка - Мимика лица {Мимика}
ультиматист - Сторонник ультиматизма {Сторонник}
ум","браться","ум-разум - способность человек {способность}
умножитель - умножитель частоты {умножитель}
умозаключение - процесс выведения {процесс}
умонастроение - Направленность ума {Направленность}
уморение - Обработка волоса {Обработка}
умыкание - Похищение невесты {Похищение}
унанимист - Последователь унанимизма {Последователь}
универмаг - Сокращение слов {Сокращение}
универсалист - Сторонник универсализма {Сторонник}
универсант - Студент университета {Студент}
униформист - Работник цирка {Работник}
унтер-офицерство - Звание унтер-офицера {Звание}
унтер-офицерша - Жена унтер-офицера {Жена}
уныние - состояние духа {состояние}
упадок - Состояние разрушения {Состояние}
упадочник - Выразитель эпохи {Выразитель}
упитанность - Состояние организма {Состояние}
управдел","управделами - Сокращение слов {Сокращение}
управдом - Сокращение слов {Сокращение}
управец - Служащий управы {Служащий}
управительша - Жена управителя {Жена}
управляемость - Свойство машины {Свойство}
упряжка - лошадей (обл {лошадей}
упряжь - Совокупность приспособлений {Совокупность}
упёк - Качество выпечки {Качество}
ура - клич войск {клич}
уравниловка - система оплаты {система}
уралец - Житель Урала {Житель}
уремия - Отравление организма {Отравление}
урожай - Количество хлеба {Количество}
уроженец - Человек родом {Человек}
урология - Отдел медицины {Отдел}
урядничиха - Жена урядника {Жена}
усвояемость - Степень легкости {Степень}
усилие - Напряжение силы {Напряжение}
услужение - Состояние того {Состояние}
успеваемость - Степень успешности {Степень}
уста - Рот губы {Рот}
устой - опора моста {опора}
устрицеводство - Разведение устриц {Разведение}
устье - Место впадения {Место}
утварь - Совокупность предметов {Совокупность}
утлегарь - Продолжение бушприта {Продолжение}
утомление - Ослабление сил {Ослабление}
утомляемостъ - Свойство организма {Свойство}
утятина - Мясо утки {Мясо}
утёнок - Птенец утки {Птенец}
ухо - Орган слуха {Орган}
учительша - Учительница (обл {Учительница}
учком - Сокращение слов {Сокращение}
учредиловец - Член учредилки {Член}
учредитель - Основатель какого {Основатель}
уют - Совокупность удобств {Совокупность}
фабрикант - Капиталист фабрики {Капиталист}
фабула - Содержание событий {Содержание}
фагоцитоз - Поглощение веществ {Поглощение}
фазанина - Мясо фазана {Мясо}
фаланга - строй пехоты {строй}
фаланстер","фаланстера - учении фурьеристов {учении}
фалда - пола одежды {пола}
фальсификация - Подделывание чего {Подделывание}
фальшборт - Выступ борта {Выступ}
фанатизм - Образ мыслей {Образ}
фанера - пластина дерева {пластина}
фанерка - пластинка фанеры {пластинка}
фантазия - воображение выдумки {воображение}
фанфаронство - Поведение фанфарона {Поведение}
фараон - Титул др {Титул}
фарингит - Воспаление зева {Воспаление}
фарисейство - Учение фарисеев {Учение}
фарман - Биплан системы {Биплан}
фас - сторона чего {сторона}
фасет","фасетка - грань чего {грань}
фаска - сторона лезвия {сторона}
фасон - Покрой чего {Покрой}
фата - кисеи шелка {кисеи}
фашина - Связка прутьев {Связка}
фашист - Сторонник фашизма {Сторонник}
федералист - Сторонник федерализма {Сторонник}
фейербахианец - Последователь фейербахианства {Последователь}
фейерверкер - Унтер-офицер артиллерии {Унтер-офицер}
фекалия - масса испражнения {масса}
фельдмаршальство - Звание фельдмаршала {Звание}
фельдшер - помощник (см {помощник}
фемида - Олицетворение правосудия {Олицетворение}
феминист - Поборник феминизма {Поборник}
феникс - -греч мифологии {-греч}
фенология - Отдел биологии {Отдел}
феноменалист - Сторонник феноменализма {Сторонник}
феноменология - философии Гегеля {философии}
феод - владение феодала {владение}
ферментация - Процесс брожения {Процесс}
фермерство - Занятие фермера {Занятие}
ферросплав - Сплав какого {Сплав}
ферт - буквы «ф {буквы}
фетишист - фетишам (см {фетишам}
фехтмейстер - Учитель фехтования {Учитель}
фигура - очертание формы {очертание}
фигурант - Танцовщик балета {Танцовщик}
фидеист - Последователь фидеизма {Последователь}
физика - наука естествознания {наука}
физиогномика - Искусство определения {Искусство}
фикс - сумма вознаграждения {сумма}
фиктивность - Отвлеч суш {Отвлеч}
филиация - Развитие чего {Развитие}
филистерство - Поведение филистера {Поведение}
филогенез - Процесс развития {Процесс}
филология - Совокупность наук {Совокупность}
фининспектура - Фининспекторы см {Фининспекторы}
финляндцы - Жители Финляндии {Жители}
финплан - план см {план}
финтифанты - увертки вещицы {увертки}
фирман - Указ султана {Указ}
фискал - эпоху Петра {эпоху}
фихтеанец - Последователь философии {Последователь}
флагман","инженер-флагман - Начальник эскадры {Начальник}
флебит - Воспаление вен {Воспаление}
флегмона - воспаление клетчатки {воспаление}
флексия - Способ образования {Способ}
флибустьерство - Деятельность флибустьеров {Деятельность}
флигель-адъютантство - Звание флигель-адъютанта {Звание}
флигельман - Фланговый солдат {Фланговый}
флорин - монета (истор {монета}
флот - Совокупность судов {Совокупность}
флотация - Способ обогащения {Способ}
флуктуация - Колебание (см {Колебание}
флуоресценция - Свечение нек {Свечение}
фок-мачта - мачта судна {мачта}
фок-рей","фок-рея - рея фок-мачты {рея}
фокус - Точка пересечения {Точка}
фон","фон-барон - Немец человек {Немец}
фонема - Звук речи {Звук}
фонетика - Отдел языкознания {Отдел}
фонология - Отдел языкознания {Отдел}
фонтан - Струя воды {Струя}
фора - Возглас одобрения {Возглас}
форд - автомобиль типа {автомобиль}
форель - рыба род {рыба}
форзац - лист книги {лист}
форма - очертания вместилища {очертания}
формула - выражение состава {выражение}
форте - силу звука {силу}
форштадт - Предместье города {Предместье}
форштевень - оконечность судна {оконечность}
фосген - Соединение хлора {Соединение}
фосфоресценция - Свойство нек {Свойство}
фот - Единица освещенности {Единица}
фотогравюра - Репродукция картины {Репродукция}
фотография - Получение изображений {Получение}
фотокарточка - карточка См {карточка}
фотолюбитель - Фотограф См {Фотограф}
фотометрия - Измерение силы {Измерение}
фотомеханика - Совокупность каких {Совокупность}
фотосинтез - Процесс создания {Процесс}
фототипия - Способ печатания {Способ}
фотохимия - Отдел химии {Отдел}
фотохроника - Хроника событий {Хроника}
фрагмент - Отрывок текста {Отрывок}
фразеология - Совокупность приемов {Совокупность}
фразёрство - Способ выражения {Способ}
фракционер - Член какой {Член}
фракция - группа членов {группа}
фрамуга - створка окна {створка}
франк - единица Франции {единица}
франт - человек (пренебр {человек}
фребеличка - Воспитательница детей {Воспитательница}
фригория - единица холода {единица}
фриз - ткань типа {ткань}
фризура","фризюра - Прическа (см {Прическа}
фрикация - физиологии звуков {физиологии}
фритредер - Сторонник фритредерства {Сторонник}
фрондёр - Участник фронды {Участник}
фронтиспис - фасад здания {фасад}
фрукт - плод какого {плод}
фруктовщик - Торговец фруктами {Торговец}
фтизиатрия - Отрасль медицины {Отрасль}
функционализм - теория денег {теория}
функционалист - Сторонник функционализма {Сторонник}
функционалка - Система управления {Система}
фуражировка - Заготовка продовольствия {Заготовка}
фурункул - воспаление кожи {воспаление}
фурьерист - Последователь фурьеризма {Последователь}
футурист - Последователь футуризма {Последователь}
фухтель - сторона клинка {сторона}
ха - буквы «х {буквы}
хавтайм - Половина игры {Половина}
хаз - Край куска {Край}
хамиты - Группа народностей {Группа}
хамовник - Ткач (полотна {Ткач}
хан - Титул монарха {Титул}
хапанцы - вознаграждение взятки {вознаграждение}
харчо - кушанье род {кушанье}
хасид - Последователь хасидизма {Последователь}
хворост - сучья ветви {сучья}
хвостизм - тактика следования {тактика}
хедер - аппарат комбайна {аппарат}
хедив - титул вице-короля {титул}
хеймверовец - Участник хеймвера {Участник}
хер - буквы «х {буквы}
хиазм","хиазма - Перестановка членов {Перестановка}
хивинцы - жителей ханства {жителей}
химизация - внедрение достижений {внедрение}
химизм - природа какого {природа}
хина - корка (см {корка}
хипесничество - Занятие хипесника {Занятие}
хирагра - Подагра рук {Подагра}
хирургия - Отдел медицины {Отдел}
хитрец - человек жука {человек}
хищничество - Способ существования {Способ}
хлебец - хлеб (см {хлеб}
хлебодар - Раздатчик хлеба {Раздатчик}
хлебозаготовка - Заготовка хлеба {Заготовка}
хлебопечение - Выпечка хлеба {Выпечка}
хлебопродукты - Продукты обмолота {Продукты}
хлебосдатчик - Сдатчик хлеба {Сдатчик}
хлебосдача - Сдача хлеба {Сдача}
хлебоуборка - Уборка хлебов {Уборка}
хлопководство - Разведение хлопка {Разведение}
хлопкопрядение - Прядение хлопка {Прядение}
хлопкоуборка - Уборка хлопка {Уборка}
хлопушка - Лоскут кожи {Лоскут}
хлорофилл - вещество листьев {вещество}
хлуп","хлупь - Кончик крестца {Кончик}
хлыст - Последователь хлыстовства {Последователь}
хлыщ - человек фат {человек}
хмелеводство - Разведение хмеля {Разведение}
хмелина - Ветка хмеля {Ветка}
хмель - Состояние опьянения {Состояние}
хна - нек растений {нек}
ходимость - Прочность (предметов {Прочность}
хозрасчёт - ведение хозяйства {ведение}
хозяйство - производства предметов {производства}
хозяюшка - Ласкат к {Ласкат}
холмообразование - Образование холмов {Образование}
холод - температура воздуха {температура}
холопство - Состояние холопа {Состояние}
холуйство - Холуи (см {Холуи}
хорда - точки какой {точки}
хореография - Искусство танца {Искусство}
хорист - Артист хора {Артист}
хормейстер - Руководитель хора {Руководитель}
хороводник - хороводе (обл {хороводе}
хоромы - постройка (обл {постройка}
хоругвь - знамя (истор {знамя}
хохлатка - птица бабочки {птица}
хохол - устах шовинистов {устах}
хохол - клок волос {клок}
хохотун - хохоту человек {хохоту}
храбрость - Отсутствие страха {Отсутствие}
храмоздатель - Создатель храма {Создатель}
храмоздательство - Строительство храмов {Строительство}
храп - пленка льда {пленка}
храпок - Звук храпа {Звук}
хренина - Корень хрена {Корень}
хреновина - корень хрена {корень}
хрипота - Наличие хрипа {Наличие}
христарадник - Нищий (см {Нищий}
христианизация - Придание чему {Придание}
христос - лица Иисуса {лица}
хроматин - вещество ядра {вещество}
хромолитография - способ печатания {способ}
хромоногость - Наличие хромоты {Наличие}
хромофотография - Способ получения {Способ}
хроника - Запись событий {Запись}
хроникёр - Сотрудник газеты {Сотрудник}
хронист - Составитель хроники {Составитель}
хронология - Перечень событий {Перечень}
хронометраж - Изучение продолжительности {Изучение}
хруст - Треск чего {Треск}
хряк - Самец свиньи {Самец}
худоба - Сухость тела {Сухость}
художество - Искусство (старин {Искусство}
хунта - объединений комитетов {объединений}
хуторянка - Жительница хутора {Жительница}
цапка - мотыга (см {мотыга}
цапонлак - раствор целлулоида {раствор}
царевич - Сын царя {Сын}
царевна - Дочь царя {Дочь}
цареубийство - Убийство царя {Убийство}
цареубийца - Убийца царя {Убийца}
царица - Жена царя {Жена}
царишка - Царь (см {Царь}
цаца - игрушка (обл {игрушка}
цветность - Наличие яркости {Наличие}
цветоводство - Разведение цветов {Разведение}
це - буквы «ц {буквы}
цевка - Трубка (обл {Трубка}
цеж - раствор чего {раствор}
цейтнот - Отсутствие времени {Отсутствие}
целовальник - Продавец вина {Продавец}
цена - Стоимость чего {Стоимость}
ценник - Указатель цен {Указатель}
центр - Точка сосредоточения {Точка}
централизм - Система управления {Система}
центрист - Последователь центризма {Последователь}
центурион - Начальник центурии {Начальник}
цепка - цепь (см {цепь}
цепочка - цепь бойцов {цепь}
цепь - Ряд гор {Ряд}
церемониймейстер - придворных чинов {придворных}
церемония - совершение чего {совершение}
церковница - Жена церковника {Жена}
цесаревич - Звание наследника {Звание}
цесаревна - Дочь царя {Дочь}
цех - Отделение фабрики {Отделение}
цивилизация - степень развития {степень}
цигейка - мех козы {мех}
цикл - Совокупность каких {Совокупность}
циклон - движение атмосферы {движение}
цинизм - Учение циников {Учение}
цирик - Боец армии {Боец}
циркач - Артист цирка {Артист}
циркачество - Исполнение чего {Исполнение}
цирлих-манирлих - неизмен прил {неизмен}
цирроз - Уплотнение органа {Уплотнение}
цитология - Отдел биологии {Отдел}
цокот - цоканье (см {цоканье}
цуг - Запряжка лошадей {Запряжка}
цукат - корка плода {корка}
цыпки - состояние кожи {состояние}
цыплятина - Мясо цыпленка {Мясо}
цыплятница - Эпитет лисы {Эпитет}
цыплёнок - Птенец курицы {Птенец}
цыпушка - Ласкат к {Ласкат}
чадородие - Рождение детей {Рождение}
чадорождение - Рождение детей {Рождение}
чаеобработка - Обработка чая {Обработка}
чаепитие - Питье чая {Питье}
чалма - кусок материи {кусок}
чапиги - Поручни плуга {Поручни}
чародейство - Искусство чародея {Искусство}
чартизм - движение рабочих {движение}
частушечник - Исполнитель частушек {Исполнитель}
чахотка - Туберкулез легких {Туберкулез}
че - буквы «ч {буквы}
чеботарь - Сапожник человек {Сапожник}
человекодень - Единица исчисления {Единица}
человеконенавистничество - Образ мыслей {Образ}
человекоубийство - Убийство человека {Убийство}
человекоубийца - Убийца человека {Убийца}
человекочас - Единица исчисления {Единица}
человечина - Увелич к {Увелич}
человечище - Увелич к {Увелич}
челядинец - Слуга человек {Слуга}
чемпионство - Звание чемпиона {Звание}
черва - Личинки пчел {Личинки}
червь - животное насекомого {животное}
червь - буквы «ч {буквы}
чердачник - Житель чердака {Житель}
череззерница - образование зерен {образование}
черемисы - народности мари {народности}
черенок - Рукоятка какого {Рукоятка}
череп - Кости головы {Кости}
черепашина - Мясо черепахи {Мясо}
черепица - пластинки плитки {пластинки}
черничина - Ягода черники {Ягода}
черносливина - ягода чернослива {ягода}
чертёж - Изображение чего {Изображение}
четвертак - Четверть рубля {Четверть}
четвертование - способ казни {способ}
четырёхполье - Система севооборота {Система}
чечет - Самец чечетки {Самец}
чешуйка - пластинка чешуи {пластинка}
чивиканье - Щебетанье птицы {Щебетанье}
чиновница - Жена чиновника {Жена}
чиновничество - Чиновники (см {Чиновники}
чинодрал - Чиновник (см {Чиновник}
чинуша - Чиновник (см {Чиновник}
чириканье - Щебетание птицы {Щебетание}
чируха - Самка чирка {Самка}
чирятина - Мясо чирка {Мясо}
чирёнок - Детеныш чирка {Детеныш}
чистоган - деньги (см {деньги}
чистюля - любитель чистоты {любитель}
членовредительство - повреждение какого {повреждение}
чоканье - Произношение звука {Произношение}
чолка - Прядь гривы {Прядь}
чресла - Поясница бедра {Поясница}
чуб - Клок волос {Клок}
чувствилище - выразителем чувства {выразителем}
чудотворство - Творение чудес {Творение}
чужак - человек существо {человек}
чуйка - кафтан армяк {кафтан}
чулок - Принадлежность белья {Принадлежность}
чурбан - Обрубок дерева {Обрубок}
чухонец - обозначение финна {обозначение}
ш","ша - буквы «ш {буквы}
шабала - шумовка (обл {шумовка}
шабат - основание наковальни {основание}
шабер - инструмент род {инструмент}
шабли - вина винограда {вина}
шавера - люди сброд {люди}
шайка - Группа людей {Группа}
шалтай-болтай - Вздор человек {Вздор}
шаманство - Культ духов {Культ}
шаривари - концерт (см {концерт}
шаромыжничество - Образ действий {Образ}
шах - Титул монарха {Титул}
шахермахерство - Деятельность действия {Деятельность}
шашка - Кусок дерева {Кусок}
швейцарцы - Граждане Швейцарии {Граждане}
швец - Портной (старин {Портной}
шедёвр - произведение (искусства {произведение}
шеища - Увелич к {Увелич}
шелководство - Разведение шелкопряда {Разведение}
шеллак - вещество нек {вещество}
шерстезаготовка - Заготовка шерсти {Заготовка}
шерстопрядение - Прядение шерсти {Прядение}
шерстоткачество - Тканье изделий {Тканье}
шерсть - покров тела {покров}
шестидесятник - деятель 60-х {деятель}
шестидневка - Период времени {Период}
шестиполье - система полеводства {система}
шефство - Исполнение обязанностей {Исполнение}
шинкарь - Содержатель шинка {Содержатель}
ширина - Протяжение чего {Протяжение}
ширинка - отрез ткани {отрез}
шихта - Смесь материалов {Смесь}
шиш - вершина чего {вершина}
шкалик - Мера вина {Мера}
шкаф - Предмет мебели {Предмет}
шквал - порыв ветра {порыв}
шлиф - пластинка металла {пластинка}
шляпёнка - шляпа (см {шляпа}
шоколадка - плитка шоколада {плитка}
шотландцы - население Шотландии {население}
шофёр - Водитель автомобиля {Водитель}
шпат - воспаление костей {воспаление}
шпиндель - вал станков {вал}
шпионаж - деятельность шпиона {деятельность}
шплинт - кусок проволоки {кусок}
шпорец - вырост чашечки {вырост}
штаб - Орган командования {Орган}
штаб-квартира - Место расположения {Место}
штабель - ряд чего {ряд}
шталмейстер - придворных чинов {придворных}
штамб - Ствол дерева {Ствол}
штамп - изготовления деталей {изготовления}
штат - состав сотрудников {состав}
штатгальтер - правителей областей {правителей}
штирборт - борт судна {борт}
штоф - Мера вина {Мера}
штука - предмет какое {предмет}
штундист - Последователь штундизма {Последователь}
штуф - кусок минерала {кусок}
шугай - кофты сарафана {кофты}
шум - Звук речи {Звук}
шумовик - зверь (охот {зверь}
шурин - брат жены {брат}
шуры-муры - похождения дела {похождения}
шушера - люди сброд {люди}
шёлкопрядение - Производство пряжи {Производство}
шёрстность - Качество шерсти {Качество}
щ","ща - буквы «щ {буквы}
щебешок - Кусок щебня {Кусок}
щегловка - Самка щегла {Самка}
щеглёнок - Птенец щегла {Птенец}
щенок - Детеныш собаки {Детеныш}
щетинщик - Скупщик щетины {Скупщик}
щипец - морда (охот {морда}
щитовка - нек насекомых {нек}
щурёнок - Детеныш щуки {Детеныш}
щучина - Мясо щуки {Мясо}
щёлочность - Степень насыщения {Степень}
ы - буквы «ы {буквы}
э - буквы «э {буквы}
эвакуация - вывоз кого {вывоз}
эволюционист - Сторонник эволюционизма {Сторонник}
эвристика - Совокупность приемов {Совокупность}
эгалитарист - Сторонник эгалитаризма {Сторонник}
экзегетика - Совокупность правил {Совокупность}
экзекуция - наказание (офиц {наказание}
экземпляр - список какой {список}
экзот - Экземпляр какого {Экземпляр}
экипаж - повозка корабля {повозка}
экология - Отдел биологии {Отдел}
экоссез","экосез - танец кадрили {танец}
экранизация - Приспособление чего {Приспособление}
экс - Сокращение слова {Сокращение}
экскурсант - Участник экскурсии {Участник}
экскурсовод - Руководитель экскурсии {Руководитель}
экспансионист - Сторонник экспансионизма {Сторонник}
экспансия - Расширение границ {Расширение}
экспатриация - выселение кого {выселение}
экспертиза - Рассмотрение какого {Рассмотрение}
эксплантация - Пересадка какой {Пересадка}
эксплоатация - Извлечение выгоды {Извлечение}
экспозе - изложение какого {изложение}
экспонент - Владелец экспоната {Владелец}
экспрессионист - Сторонник экспрессионизма {Сторонник}
экспрессия - выразительность чему {выразительность}
экссудация","эксудация - Процесс образования {Процесс}
экстернат - Система прохождения {Система}
экстерриториальность - Изъятие иностранцев {Изъятие}
экстирпация - удаление какого {удаление}
экстремист - Сторонник экстремизма {Сторонник}
эксцесс - проявление чего {проявление}
электродвигатель - двигатель См {двигатель}
электродинамика - Отдел физики {Отдел}
электролиз - Разложение вещества {Разложение}
электролит - Раствор какого {Раствор}
электромагнит - Кусок железа {Кусок}
электрометаллургия - Отрасль техники {Отрасль}
электромеханика - Отдел электротехники {Отдел}
электросварка - Сварка металлов {Сварка}
электростатика - Отдел физики {Отдел}
элизия - поэзии нек {поэзии}
эль - буквы «л {буквы}
эм - буквы «м {буквы}
эманация - Истечение чего {Истечение}
эмбарго - Запрещение ввоза {Запрещение}
эмбриология - Отдел биологии {Отдел}
эмбрион - Зародыш (растения {Зародыш}
эмиссарство - Работа эмиссара {Работа}
эмфизема - скопление воздуха {скопление}
эн - буквы «н {буквы}
энгармонизм - Отождествление тонов {Отождествление}
эндокардит - Воспаление эндокардия {Воспаление}
энергетик - Сторонник энергетики {Сторонник}
энергия - свойств материи {свойств}
энтомология - Отдел зоологии {Отдел}
энциклика - послание епископа {послание}
эпентеза - Вставка звука {Вставка}
эпигон - Последователь какого {Последователь}
эпиграмматист - Автор эпиграмм {Автор}
эпидерма","эпидермис - слой покрова {слой}
эпизоотия - болезнь скота {болезнь}
эпикард","эпикардий - оболочка сердца {оболочка}
эпикардит - Воспаление эпикардия {Воспаление}
эпикуреец - Последователь эпикуреизма {Последователь}
эполеты - Погон (см {Погон}
эпоха - Промежуток времени {Промежуток}
эр - буквы «р {буквы}
эрг - Единица работы {Единица}
эрекция - Набухание нек {Набухание}
эрцгерцог - Титул членов {Титул}
эсдек - Социал-демократ (см {Социал-демократ}
эсер - Социалист (см {Социалист}
эскиз - набросок (картины {набросок}
эсминец - Сокращение слов {Сокращение}
эсперантист - Сторонник эсперанто {Сторонник}
эстетство - Поведение привычки {Поведение}
этажность - Количество этажей {Количество}
эталон - Образец меры {Образец}
этикет - порядок образа {порядок}
этикетаж - Изготовление этикеток {Изготовление}
этимологизация - Установление этимологии {Установление}
этимология - Отдел языкознания {Отдел}
эф - буквы «ф {буквы}
эхо - Отражение звука {Отражение}
ю - буквы «ю {буквы}
юбилей - Празднование годовщины {Празднование}
юг - стран государства {стран}
юго-восток - Сторона горизонта {Сторона}
юго-запад - Сторона горизонта {Сторона}
юдофильство - Образ мыслей {Образ}
юдофоб - Ненавистник евреев {Ненавистник}
юдофобство - Образ мыслей {Образ}
южанин - Уроженец юга {Уроженец}
юиты - эскимосы (см {эскимосы}
юкка - Растение семейства {Растение}
юнкерство - Юнкеры юнкера {Юнкеры}
юнкерьё - Юнкера (см {Юнкера}
юношество - Возраст юноши {Возраст}
юнсекция - секция См {секция}
юпитер - прибор род {прибор}
юрисконсультство - Должность юрисконсульта {Должность}
ябедничество - Занятие ябедника {Занятие}
яблоко - Плод яблони {Плод}
ягнёнок - Детеныш овцы {Детеныш}
яйцеклетка - клетка животных {клетка}
яйцерождение - Воспроизведение потомства {Воспроизведение}
яловость - Ликвидация яловости {Ликвидация}
янсенист - Последователь янсенизма {Последователь}
яр - берег реки {берег}
ярд - мера поверхности {мера}
ярлык - указ веса {указ}
яровизация - обработка семян {обработка}
ярыга - служитель (истор {служитель}
ястребёнок - Птенец ястреба {Птенец}
ящер - Африке н {Африке}
ящерёнок - Детеныш ящерицы {Детеныш}
ёж - Вин п {Вин}
ёрш - Смесь водки {Смесь}
