авторитет - общепризнанное значение {значение}
азарт - сильное возбуждение {возбуждение}
аккомпанемент - музыкальное сопровождение {сопровождение}
алоэ - южное растение {растение}
амнистия - полное снятие {снятие}
амулет - небольшой предмет {предмет}
аналогия - содержательная близость {близость}
ангина - инфекционное заболевание {заболевание}
арена - круглую площадка {площадка}
аромат - приятный запах {запах}
артист - профессиональный исполнитель {исполнитель}
атака - решительное движение {движение}
баня - специальная постройка {постройка}
бар - небольшой шкаф {шкаф}
бегемот - крупное парнокопытное {парнокопытное}
бездна - бездонная глубина {глубина}
бездорожье - плохого состояние {состояние}
безе - кондитерское изделие {изделие}
безумство - крайняя степень {степень}
бес - мифологическое существо {существо}
беспамятство - внезапная потеря {потеря}
беспорядочный - логические связь {связей}
бессознательность - непроизвольное чувство {чувство}
бесчинство - недостойное поведение {поведение}
бидон - пластмассовая емкость {ёмкость}
бизнес - экономическая деятельность {деятельность}
биография - литературный жанр {жанр}
благополучие - счастливое состояние {состояние}
благородство - высокая нравственность {нравственность}
блеск - яркий свет {свет}
блузка - женская одежда {одежда}
бог - высокий объект {объект}
богатство - большого количество {количество}
богатство - внешнее великолепие {великолепие}
богатый - внешнее себя {себе}
бой - вооружённое столкновение {столкновение}
болото - топкое место {место}
болтовня - бессодержательная речь {речь}
больница - лечебное учреждение {учреждение}
борода - волосяной покров {покров}
борьба - активная деятельность {деятельность}
ботинки - уличная обувь {обуви}
брак - семейный отношение {отношения}
брань - грубый слово {слова}
бревно - гимнастический снаряд {снаряд}
бродяга - бездомный человек {человек}
броня - защитная обшивка {обшивка}
брюзжание - надоедливое выражение {выражение}
бык - рогатое животное {животное}
быль - рогатое то {То}
бюстгальтер - нижнее белье {бельё}
важность - большого значение {значение}
валенки - мягкая обувь {обуви}
век - исторический период {период}
век - продолжительный период {период}
велосипед - транспортное средство {средство}
вера - религиозное учение {учение}
вера - твёрдое мнение {мнение}
вереница - непрерывный ряд {ряд}
вероятность - объективная возможность {возможность}
веха - основной период {период}
вещь - предметное изделие {изделие}
вещь - отдельный предмет {предмет}
взаимопомощь - взаимная поддержка {поддержка}
вилка - металлический стержень {стержень}
витютень - металлический голубь {голубь}
вклад - денежный средство {средства}
влажность - повышенное содержание {содержание}
влечение - непреодолимое стремление {стремление}
возбуждение - сильное возбуждение {возбуждение}
возлюбленная - любимая женщина {женщина}
возлюбленный - любимый человек {человек}
возможность - благоприятное стечение {стечение}
возмущение - крайнее недовольство {недовольство}
война - опасная борьба {борьба}
волдырь - подкожный пузырь {пузырь}
волк - хищное животное {животное}
волна - водяной бугор {бугор}
волос - волосяной покров {покров}
волосы - нитевидный образование {образования}
волшебник - сказочный персонаж {персонаж}
воспоминания - мысленное воспроизведение {воспроизведение}
восторг - сильный подъем {подъём}
восхваление - чрезмерная похвала {похвала}
восхищение - высокая степень {степень}
вред - материальный потеря {потери}
время - отдельный промежуток {промежуток}
вторжение - неправомерное вхождение {вхождение}
вулкан - значительную возвышенность {возвышенность}
вывод - логический итог {итог}
выдержка - небольшой отрывок {отрывок}
выпад - враждебное выступление {выступление}
высокомерие - высокое мнение {мнение}
высокомерие - твёрдая уверенность {уверенность}
гадание - предварительное суждение {суждение}
гардероб - высокий шкаф {шкаф}
геральдика - историческая наука {наука}
гибельный - большого вред {вред}
гимн - восторженная хвала {хвала}
глаза - парный орган {орган}
голод - сильное желание {желание}
гордец - высокомерный человек {человек}
гордость - высокое мнение {мнение}
горе - душевное страдание {страдание}
городки - народная игра {игра}
горшок - открытая емкость {ёмкость}
госпиталь - лечебное учреждение {учреждение}
гостеприимство - ласковое отношение {отношение}
граница - допустимая норма {норма}
граница - разграничительная линия {линия}
граница - разграничительная черта {черта}
гримаса - непроизвольное искажение {искажение}
громоотвод - металлический стержень {стержень}
грубость - грубое слово {слово}
грудь","груди - молочный железа {железы}
дар - высокая степень {степень}
дача - загородный дом {дом}
девушка - загородный женщина {женщина}
действенный - нужное действие {действие}
деликатес - вкусное кушанье {кушанье}
десерт - вкусное блюдо {блюдо}
деспот - самовластный человек {человек}
десятирублёвка - денежный знак {знак}
дикарь - жестокий человек {человеке}
дикарь - невежественный человек {человеке}
доброта - душевное расположение {расположение}
дозор - небольшая группа {группа}
доказательство - неопровержимый довод {довод}
доклад - официальное сообщение {сообщение}
документ - письменное свидетельство {свидетельство}
должность - служебное положение {положение}
доллар - денежный знак {знак}
доля - общее дело {дело}
донос - тайное сообщение {сообщение}
достоинство - положительное качество {качество}
дрожь - судорожное вздрагивание {вздрагивание}
дрожь - судорожное сокращение {сокращение}
дрожь - судорожное сокращение {сокращение}
дуновение - судорожное движение {движение}
дурак - упрямый человек {человек}
душа - внутренний мир {мир}
дьявол - злой дух {дух}
единение - тесная связь {связь}
единобрачие - семейный отношение {отношения}
единство - полное слияние {слияние}
жар - повышенная температура {температура}
желание","желанье - внутреннее стремление {стремление}
железная дорога - металлические рельс {рельсы}
жестокость - беспощадный поступок {поступок}
жестокость - крайняя грубость {грубость}
жизнерадостность - радостное мироощущение {мироощущение}
жизнь - физиологическое состояние {состояние}
забастовка - массовое прекращение {прекращение}
завет - предсмертная воля {воля}
заграница - зарубежный страна {страны}
задание - учебная работа {работа}
заливное - учебная кушанье {кушанье}
замазка - вязкое вещество {вещество}
заморыш - слабый человек {человек}
запасы - денежный средство {средства}
записка - небольшой текст {текст}
запрет - категоричное предписание {предписание}
зарница - оптическое явление {явление}
заря - оптическое явление {явление}
заслон - воинское подразделение {подразделение}
захолустье - малолюдное место {место}
зачатие - биологический процесс {процесс}
заяц - пугливый зверек {зверёк}
здание - архитектурное сооружение {сооружение}
зловоние - отвратительный запах {запах}
злословие","злословье - злая оценка {оценка}
злословие","злословье - враждебная оценка {оценка}
знак - внешнее обнаружение {обнаружение}
значение - внутреннее содержание {содержание}
известность - широкое признание {признание}
изгиб - дугообразный поворот {поворот}
изречение - глубокая мысль {мысль}
имение - земельное владение {владение}
импровизация - небольшое стихотворение {стихотворение}
имущество - мелкие предмет {предметы}
иней - атмосферный осадки {осадки}
инжир - древесное растение {растение}
инструмент - техническое приспособление {приспособление}
интуиция - неосознанное чувство {чувство}
ирония - скрытая насмешка {насмешка}
искусственный - естественное происхождение {происхождения}
исповедник - христианский священник {священник}
истерия - судорожная деятельность {деятельность}
истерия - пристрастное выражение {выражение}
кайма - цветная полоска {полоска}
календула - травянистое растение {растение}
кальсоны - нижнее белье {бельё}
каморка - тесное помещение {помещение}
кант - цветной шнурок {шнурок}
каприз - своенравное желание {желание}
капризник - капризный человек {человек}
каравай - круглый хлеб {хлеб}
кафе - небольшой ресторан {ресторан}
кафель - тонкая плитка {плитка}
кашлять - сильные толчок {толчками}
кепка - головной убор {убор}
кино - изобразительное искусство {искусства}
классификация - логическая система {система}
клевер - кормовое растение {растение}
клевета - ложная информация {информация}
кожура - внешняя оболочка {оболочка}
количество - численный состав {состав}
коллекционирование - целенаправленное собирание {собирание}
колокольня - высокое сооружение {сооружение}
комната - отдельное помещение {помещение}
компьютер - электронное устройство {устройство}
конвейер - механическое устройство {устройство}
конец - последний момент {момент}
контур - графическое изображение {изображение}
копир - множительный аппарат {аппарат}
коран - священная книга {книга}
корова - рогатое животное {животное}
корона - головной убор {убор}
коронация - торжественная церемония {церемония}
коротышка - низкорослый человек {человек}
кот - домашнее животное {животное}
котловина - большого углубление {углубление}
кошелёк - карманный размер {размера}
кощунство - оскорбительное отношение {отношение}
край - предельная линия {линия}
красавица - миловидная женщина {женщина}
крещение - православные праздник {праздников}
крик - напряг звук {звук}
крик - резкий звук {звук}
критика - неблагоприятная оценка {оценка}
крокодил - водное пресмыкающееся {пресмыкающееся}
кудри - завитые волос {волосы}
кукуруза - травянистое растение {растение}
кулик - болотная птица {птица}
кулёк - прямоугольное вместилище {вместилище}
кусачки - острые щипцы {щипцы}
кутия","кутья - поминальное блюдо {блюдо}
кутёж - буйное веселие {веселье}
куча - большого количество {количество}
кушетка - небольшой диван {диван}
ладонь - внутренняя сторона {сторона}
ладья - шахматная фигура {фигура}
легенда - литературный жанр {жанр}
леопард - хищное млекопитающее {млекопитающее}
лесть - угодливое восхваление {восхваление}
линия - длинная полоса {полоса}
линия - узкая полоса {полоса}
линия - узкая полоса {полоса}
лисица - хищное млекопитающее {млекопитающее}
литургия - христианское богослужение {богослужение}
ловушка - скрытное расположение {расположение}
ложь - намеренное искажение {искажение}
лось - крупное жвачное {жвачное}
лошадь - крупное непарнокопытное {непарнокопытное}
луна - небесное тело {тело}
льстец - льстивый человек {человек}
лягушка - бесхвостое земноводное {земноводное}
лямки - узкий полоска {полоски}
магазин - торговое предприятие {предприятие}
малёк - маленькая рыбка {рыбка}
манекенщица - маленькая себя {себе}
манёвры","маневры - тактический занятие {занятия}
маслина - плодовое дерево {дерево}
мастерская - небольшое предприятие {предприятие}
мастерство - высокий уровень {уровень}
медведь - всеядное млекопитающее {млекопитающее}
мелодия - определённая последовательность {последовательность}
мемуары - литературный жанр {жанр}
местность - определённое пространство {пространство}
место - определённое пространство {пространство}
месть - намеренное причинение {причинение}
метель - сильный ветер {ветер}
метель - холодный ветер {ветер}
метро - железная дорога {дорога}
микроб - одноклеточный организм {организм}
мина - разрывный снаряд {снаряд}
мир - дружественный отношение {отношения}
мир - дружественный отношение {отношения}
мираж - оптическое явление {явление}
многобрачие - семейный отношение {отношения}
многоножка - членистоногое животное {животное}
множество - большого количество {количество}
монарх - верховный правитель {правитель}
мотоцикл - транспортное средство {средство}
мотыга - сельскохозяйственный инструмент {инструмент}
мошенник - нечестный человек {человек}
мультипликация - изобразительное искусство {искусства}
мышца - эластичное образование {образование}
набег - стремительный действие {действия}
наводнение - значительное затопление {затопление}
наглец - бесцеремонный человек {человек}
наглость - дерзкое бесстыдство {бесстыдство}
надоеда - окружающий человек {человек}
название - словесное обозначение {обозначение}
накал - крайняя степень {степень}
напряжённность - интенсивное протекание {протекание}
напряжённость - нервное состояние {состояние}
нарыв - гнойное воспаление {воспаление}
насекомое - членистоногое животное {животное}
наслаждение - высокая степень {степень}
насмешка - обидная шутка {шутка}
насмешник - насмешливый человек {человек}
настроение - душевное состояние {состояние}
насыпь - искусственное возвышение {возвышение}
небо - воздушное пространство {пространство}
небылица - литературный жанр {жанр}
невиновный - литературный себя {собой}
негодяй - нравственное отношение {отношении}
недостаток - отрицательное качество {качество}
недотрога - обидчивый человек {человеке}
незначительный - существенное значение {значения}
неистовство - необузданное проявление {проявление}
нелюдим - необщительный человек {человек}
ненастье - пасмурная погода {погода}
необдуманность - предварительное обдумывание {обдумывания}
необычность - специфические качество {качествами}
неожиданность - неожиданное обстоятельство {обстоятельство}
неожиданность - радостное удивление {удивление}
непривычность - малоизвестная необычность {необычность}
непринуждённость - непринуждённое поведение {поведение}
неприязнь - недружелюбное отношение {отношение}
нервность - повышенная возбудимость {возбудимость}
нерешительность - внутренняя робость {робость}
несчастье - трагическое событие {событие}
неудача - неблагополучное стечение {стечение}
ничтожество - никчёмный человек {человек}
новообращённый - новый последователь {последователь}
обобщение - заключительное изложение {изложение}
образ - художественное отражение {отражение}
обряд - культовый действие {действия}
объявление - печатный текст {текст}
обычай - общепринятый порядок {порядок}
обычность - общепринятые норма {нормам}
овраг - длинная впадина {впадина}
оговорка - нечаянная ошибка {ошибка}
одинаковость - полное сходство {сходство}
одиночество - внутреннее состояние {состояние}
одноколейка - железная дорога {дорога}
окончание - последняя стадия {стадия}
окрестность - окружающая местность {местность}
определение - второстепенный член {член}
определение - краткая формулировка {формулировка}
оптимизм - радостное мироощущение {мироощущение}
опьянение - физиологическое состояние {состояние}
орошение - мелиоративный мероприятие {мероприятия}
осквернение - оскорбительное издевательство {издевательство}
особь - биологический организм {организм}
осторожность - тщательная обдуманность {обдуманность}
острота - остроумное выражение {выражение}
осуждение","осужденье - сильное неодобрение {неодобрение}
отвращение - сильное чувство {чувство}
отдых - непродолжительный перерыв {перерыв}
отклик - душевное движение {движение}
отклик - ответное чувство {чувство}
отклик - отражённый звук {звук}
отметка - отличительный знак {знак}
отношения - близкое знакомство {знакомство}
отрасль - научное направление {направление}
очерк - литературный жанр {жанр}
очерёдность - непрерывное следование {следование}
очерёдность - определённая последовательность {последовательность}
ошибка - неправильное действие {действие}
палец - конечные часть {частей}
паломник - верующий человек {человек}
паника - верующий страх {страх}
панихида - заупокойная служба {служба}
паром - транспортное средство {средство}
паротит - острозаразное заболевание {заболевание}
патетика - страстная воодушевленность {воодушевленность}
пафос - страстное воодушевление {воодушевление}
перегородка - внутренняя стенка {стенка}
персонаж - действующее лицо {лицо}
пессимизм - тяжёлое состояние {состоянии}
пест - тяжёлый стержень {стержень}
петух - домашняя птица {птица}
писательство - литературное творчество {творчество}
плач - литературный жанр {жанр}
плоскогорье - обширная возвышенность {возвышенность}
поверье - сверхъестественная способность {способность}
повиновение - беспрекословное исполнение {исполнение}
поговорка - образное выражение {выражение}
поддельный - образное себя {собой}
подлинник - подлинная вещь {вещь}
подчинённый - должностное лицо {лицо}
подёргивание - судорожное движение {движение}
показание - письменное сообщение {сообщение}
покаяние - добровольное признание {признание}
поклонение - глубокое почтение {почтение}
покос - сельскохозяйственный работа {работы}
полигон - открытый участок {участок}
половник - большой ложка {ложка}
польза - положительный результат {результат}
помидор - огородное растение {растение}
портсигар - плоское вместилище {вместилище}
порция - определённое количество {количество}
порча - сверхъестественная способность {способность}
пособие - денежный средство {средства}
поступок - целенаправленное проявление {проявление}
потворство - снисходительное отношение {отношение}
потрясение - сильное расстройство {расстройство}
похвала - лестный отзыв {отзыв}
похождение - рискованный поступок {поступок}
почва - верхний слой {слой}
почтальон - почтовый служащий {служащий}
почёт - большого уважение {уважение}
поэзия - литературное творчество {творчества}
праздник - увеселительное мероприятие {мероприятие}
предлог - формальное основание {основание}
предположение - предварительное мнение {мнение}
предположение - предварительное суждение {суждение}
предчувствие - неясное чувство {чувство}
презрение","презренье - непочтительное отношение {отношение}
пренебрежение - неуважительное отношение {отношение}
преобразование - коренной изменение {изменения}
преследование - коренной нападки {нападки}
преступление - опасное действие {действие}
прибавка - основная сумма {сумма}
привидение - человекоподобное существо {существо}
признание - откровенное изложение {изложение}
приказ - категорическое требование {требование}
приказ - официальный документ {документ}
примадонна - известная артистка {артистка}
принуждение - энергичное воздействие {воздействие}
пристрастие - сильная склонность {склонность}
пристрастность - необъективное отношение {отношение}
приступ - резкое проявление {проявление}
притворство - лживое поведение {поведение}
причал - специальный канат {канат}
проблеск - оптическое явление {явление}
прогресс - поступательное движение {движение}
прогулка - увеселительное мероприятие {мероприятие}
прокурор - должностное лицо {лицо}
пропасть - узкое углубление {углубление}
пропуск - незаполненное место {место}
простак - образовал человек {человек}
простодушие - открытое отношение {отношение}
простор - незаполненное пространство {пространство}
простор - свободное пространство {пространство}
прототип - реальное лицо {лицо}
процесс - публичное разбирательство {разбирательство}
прошлое - минувшее время {время}
пряник - печёное изделие {изделие}
пустословие - бесполезный речь {речи}
пустяк - несущественное обстоятельство {обстоятельство}
пыл - психическое возбуждение {возбуждение}
пышка - мягкая лепешка {лепёшка}
пятидесятирублёвка - денежная единица {единица}
пятирублёвка - денежная единица {единица}
равнодушие - полное отсутствие {отсутствие}
размазня - слабохарактерный человек {человек}
разновидность - общая категория {категории}
разум - познавательная деятельность {деятельность}
расположение - благожелательное отношение {отношение}
рассказ - литературный жанр {жанр}
растяпа - неловкий человек {человек}
редкость - необычная вещь {вещь}
режиссёр - художественный руководитель {руководитель}
река - водный поток {поток}
репейник - сорное растение {растение}
репутация - общее мнение {мнение}
рецензия - критическая оценка {оценка}
ров - длинное углубление {углубление}
родник - длинное струя {струя}
роль - художественный образ {образ}
рубашка - нижнее белье {белье}
рубль - денежная единица {единица}
ругань - взаимный оскорбление {оскорбления}
рябина - маленькое углубление {углубление}
салки - детская игра {игра}
сало - пищевого продукт {продукт}
самовластие - жестокое подавление {подавление}
самодовольство - полное удовлетворение {удовлетворение}
самолёт - летательный аппарат {аппарат}
самоуверенность - излишняя уверенность {уверенность}
санки - излишняя сани {сани}
сахар - пищевого продукт {продукт}
свет - электромагнитное излучение {излучение}
светильник - осветительный прибор {прибор}
своевольник - своевольный человек {человек}
связи - тесный отношение {отношения}
священник - церковный иерей {иерей}
село - населил пункт {пункт}
сила - большой значимость {значимость}
синяк - подкожное кровоизлияние {кровоизлияние}
скакалка - детская игрушка {игрушка}
скандал - грубая ссора {ссора}
скелет - худой человек {человек}
склонность - постоянное влечение {влечение}
скука - тягостное чувство {чувство}
сладости - пищевых продукт {продукты}
слон - шахматная фигура {фигура}
случайность - неожиданное обстоятельство {обстоятельство}
смельчак - отважный человек {человек}
смерч - круговое движение {движение}
смех - горловые звук {звуки}
смешки - обидный слово {слова}
снисхождение - строгое отношение {отношение}
собака - домашнее животное {животное}
соблазн - домашнее себя {себе}
собрание - совместное присутствие {присутствие}
соглашение - взаимное решение {решение}
содействие - деятельное участие {участие}
сознание","сознанье - мыслительная деятельность {деятельность}
сообщение - мыслительная весть {весть}
соревнование - спортивное мероприятие {мероприятие}
сотня - денежная единица {единица}
соус - жидкая приправа {приправа}
сочувствие - участливое отношение {отношение}
спектакль - театрализовало зрелище {зрелище}
сплочённость - тесная связь {связь}
спокойствие - душевная уравновешенность {уравновешенность}
спор - словесное состязание {состязание}
срок - определённый промежуток {промежуток}
стая - большого скопление {скопление}
стеснённость - неловкое чувство {чувство}
стихотворение - литературное произведение {произведение}
страстность - страстная увлеченность {увлечённость}
страсть - сильная увлеченность {увлечённость}
страсть - сильное чувство {чувство}
стремление","стремленье - настойчивое влечение {влечение}
строение - взаимное расположение {расположение}
студень - взаимное кушанье {кушанье}
стук - отрывистый звук {звук}
судорога - болезненное сокращение {сокращение}
судьба - жизненный путь {путь}
суета - беспорядочный движение {движения}
сумрак - оптическое явление {явление}
существо - оптическое организм {организм}
тапки - мягкий туфля {туфли}
таракан - прямокрылое насекомое {насекомое}
театр - сценическое искусство {искусства}
темнота - оптическое явление {явление}
теплица - тёплое помещение {помещение}
тепло - жаркая погода {погода}
территория - земельное пространство {пространство}
ткань - трикотажное изделие {изделие}
толстуха - трикотажное женщина {женщина}
толстяк - толстый мужчина {мужчина}
торжество - неоспоримая победа {победа}
тоска - гнетущее чувство {чувство}
тост - застольное пожелание {пожелание}
трава - зелёный покров {покров}
траулер - рыболовецкое судно {судно}
требование - официальный документ {документ}
тревога - душевное волнение {волнение}
трехрублёвка - денежная единица {единица}
троица - православные праздник {праздников}
троица - христианские догмат {догматов}
тропинка - пешеходная дорога {дорога}
трудность - устранимая помеха {помеха}
трус - робкий человек {человек}
трюмо - небольшой шкафчик {шкафчике}
туалет - небольшое помещение {помещение}
туберкулёз - инфекционное заболевание {заболевание}
турник - гимнастический снаряд {снаряд}
тюрбан - головной убор {убор}
убыток - денежный ущерб {ущерб}
уверенность - твёрдая вера {вера}
угодливость - излишняя услужливость {услужливость}
удаль - безудержная смелость {смелость}
удача - счастливый случай {случай}
удивление - эмоциональное состояние {состояние}
удостоверение - официальный документ {документ}
укол - язвительное замечание {замечание}
уловка - мудрёный прием {приём}
умиротворение - мирное состояние {состояние}
унижение - нравственное состояние {состояние}
успех - общественное признание {признание}
успех - положительный результат {результат}
ухаб - большого углубление {углубление}
ущелье - узкая впадина {впадина}
фантазия - неосуществимая мечта {мечта}
ферзь - шахматная фигура {фигура}
ферма - сельскохозяйственное предприятие {предприятие}
фляга - небольшая емкость {ёмкость}
форма - внешний очертание {очертания}
фундамент - нижняя служащая {служащая}
фургон - большого автомобиль {автомобиль}
хижина - бедный домик {домик}
ход - последовательный изменение {изменения}
холл - просторное помещение {помещение}
цвет - просторное тон {тон}
цена - денежное выражение {выражение}
частица - незначительное количество {количество}
честолюбец - честолюбивый человек {человек}
чибис - небольшая птица {птица}
чувство - психическое состояние {состояние}
чудовище - огромные размер {размеров}
чуткость - сочувственное отношение {отношение}
шар - геометрическое тело {тело}
шип - остроконечное образование {образование}
шкатулка - небольшое вместилище {вместилище}
шпиль - остроконечный стержень {стержень}
шрам - плотное образование {образование}
шум - длительный звук {звук}
шуршание - глухой шум {шум}
щёки - боковой часть {части}
эпопея - литературный жанр {жанр}
юноша - литературный мужчина {мужчина}
юрок - таёжная птица {птица}
юрта - переносное сооружение {сооружение}
язвительность - злая насмешливость {насмешливость}
