абстракция - Метод исследования {Метод}
алоэ - растение семейства {растение}
ансамбль - Группа артистов {Группа}
артист - исполнитель произведений {исполнитель}
архитектура - Искусство проектирования {Искусство}
атеизм - Отсутствие веры {Отсутствие}
аукцион - Процесс продажи {Процесс}
бабушка - Мать отца {Мать}
багаж - Совокупность предметов {Совокупность}
банда - Группа преступников {Группа}
банкротство - Состояние дел {Состояние}
безволие - Отсутствие силы {Отсутствие}
бездна - глубина моря {глубина}
бездорожье - состояние дорог {состояние}
беззаконие - Нарушение норм {Нарушение}
безумство - степень раздражения {степень}
бережливость - Качество человека {Качество}
беспамятство - потеря сознания {потеря}
беспорядочный - связей стройности {связей}
беспорядочный - порядка налаженности {порядка}
беспрепятственность - затруднений стеснений {затруднений}
бесстыдство - Отсутствие стыда {Отсутствие}
бестактность - отсутствии тактичности {отсутствии}
блеск - Отражение света {Отражение}
богатство - количество средств {количество}
богатство - Состояние хозяйства {Состояние}
богородица - Объект поклонения {Объект}
богочеловек - Объект поклонения {Объект}
бомбардировка - удары авиации {удары}
броня - обшивка танков {обшивка}
брюзжание - выражение недовольства {выражение}
бутерброд - Ломтик хлеба {Ломтик}
бык - животное отряда {животное}
век - период времени {период}
век - период времени {период}
век - Промежуток времени {Промежуток}
веки - Части глаз {Части}
вентиляция - Система устройств {Система}
вереница - ряд существ {ряд}
вероятность - возможность осуществления {возможность}
ветер - Движение потока {Движение}
веха - период времени {период}
взгляд - Образ мыслей {Образ}
видение - Продукт воображения {Продукт}
вихор - прядь волос {прядь}
влажность - содержание влаги {содержание}
внешность - Совокупность признаков {Совокупность}
внутренности - Совокупность органов {Совокупность}
воздержание - Ограничение себя {Ограничение}
возлюбленный - человек любовник {человек}
возможности - Средства условия {Средства}
возможность - стечение обстоятельств {стечение}
волк - животное семейства {животное}
волнения - Состояние недовольства {Состояние}
волос - покров тела {покров}
вопрос - обсуждения изучения {обсуждения}
востоковедение - Совокупность наук {Совокупность}
восхищение - степень удовлетворения {степень}
враждебность - Качество человека {Качество}
время - промежуток времени {промежуток}
вывод - итог рассуждения {итог}
выговор - Мера воздействия {Мера}
вымеривание - Определение величины {Определение}
выставка - Показ произведений {Показ}
гепатит - Заболевание печени {Заболевание}
гибель - Прекращение существования {Прекращение}
глаза - орган зрения {орган}
глупость - Недостаток ума {Недостаток}
гносеология - Раздел философии {Раздел}
говядина - Мясо коровы {Мясо}
городки - игра партий {игра}
граница - норма чего-либо {норма}
гримаса - искажение выражения {искажение}
грудь","груди - железы женщины {железы}
движение - Перемещение положения {Перемещение}
двойка - Отметка успеваемости {Отметка}
дед - Отец матери {Отец}
дедукция - Метод рассуждений {Метод}
делопроизводство - Совокупность работ {Совокупность}
деньги - Средство оплаты {Средство}
дети - Совокупность людей {Совокупность}
детство - Период жизни {Период}
диван - Предмет мебели {Предмет}
диспропорция - Наличие несоответствия {Наличие}
доброжелательность - Качество человека {Качество}
дозор - группа военнослужащих {группа}
долина - Место понижения {Место}
дорога - Образ жизни {Образ}
дремота - Состояние сонливости {Состояние}
дрожь - вздрагивание тела {вздрагивание}
дрожь - сокращение мышц {сокращение}
дрожь - сокращение мышц {сокращение}
дуновение - движение воздуха {движение}
душа - мир человека {мир}
единица - Отметка успеваемости {Отметка}
единство - слияние кого {слияние}
естествознание - Совокупность наук {Совокупность}
жалоба - Выражение неудовольствия {Выражение}
жар - температура тела {температура}
жизнелюб - жизнь человек {жизнь}
жизнь - Период времени {Период}
забастовка - прекращение работы {прекращение}
забота - Предмет беспокойства {Предмет}
забота - Проявление беспокойства {Проявление}
зависимость - Отсутствие самостоятельности {Отсутствие}
задержание - Лишение свободы {Лишение}
заменитель - свойствам заменяемого {свойствам}
замысел - план действий {план}
занавесь - Предмет быта {Предмет}
запас - количество чего-либо {количество}
запас - количество чего-либо {количество}
запах - Свойство веществ {Свойство}
затворничество - Образ жизни {Образ}
затор - Скопление транспорта {Скопление}
защита - Группа игроков {Группа}
заяц - зверёк отряда {зверёк}
зло - боль страдания {боль}
злословие","злословье - оценка кого {оценка}
знакомство - Процесс передачи {Процесс}
знания - Совокупность представлений {Совокупность}
значение - содержание слова {содержание}
избавление - Спасение кого {Спасение}
известность - признание заслуг {признание}
излишек - Количество чего-либо {Количество}
измена - Нарушение верности {Нарушение}
измена - Нарушение присяги {Нарушение}
имущество - предметы быта {предметы}
интерес - Сосредоточенность эмоций {Сосредоточенность}
интроспекция - Метод изучения {Метод}
инфекция - Возбудитель болезни {Возбудитель}
истерия - выражение чего-либо {выражение}
истощение - Потеря сил {Потеря}
исчезновение - Прекращение жизни {Прекращение}
исчезновение - Прекращение наличия {Прекращение}
исчезновение - Прекращение существования {Прекращение}
кавалерист - Военнослужащий кавалерии {Военнослужащий}
календарь - Лист бумаги {Лист}
календула - растение семейства {растение}
каприз - желание требование {желание}
классификация - Метод исследования {Метод}
клевер - растение семейства {растение}
книга - листы бумаги {листы}
коварство - Склонность человека {Склонность}
ковёр - Предмет быта {Предмет}
кожура - оболочка плодов {оболочка}
кокетливость - Свойство человека {Свойство}
кокетство - Поведение того {Поведение}
количество - состав чего-либо {состав}
компания - Группа лиц {Группа}
конец - момент чего-либо {момент}
контур - изображение очертаний {изображение}
кораблевождение - Совокупность наук {Совокупность}
коран - книга мусульман {книга}
корова - животное отряда {животное}
коронация - церемония принятия {церемония}
коростель - птица семейства {птица}
космонавтика - Совокупность наук {Совокупность}
косоглазие - Нарушение координации {Нарушение}
кот - животное семейства {животное}
кочан - Верхушка стебля {Верхушка}
крик - звук голоса {звук}
крик - звук голоса {звук}
кровать - Предмет мебели {Предмет}
кротость - Качество характера {Качество}
кротость - Качество характера {Качество}
кукуруза - растение семейства {растение}
кулик - птица семейства {птица}
культура - Совокупность достижений {Совокупность}
курица - птицы отряда {птицы}
курьер - Служащий учреждения {Служащий}
кушанье - Продукты питания {Продукты}
ладонь - сторона кисти {сторона}
ласка - Проявление любви {Проявление}
ласточка - птица отряда {птица}
лежак - Предмет мебели {Предмет}
лексика - Совокупность слов {Совокупность}
леопард - млекопитающее семейства {млекопитающее}
лесть - восхваление кого-либо {восхваление}
летосчисление","летоисчисление - Система определения {Система}
лисица - млекопитающее семейства {млекопитающее}
лицемерие - Несоответствие слов {Несоответствие}
лодка - Средство передвижения {Средство}
лопата - Орудие труда {Орудие}
лосятина - Мясо лося {Мясо}
любовь - Предмет любви {Предмет}
лямки - полоски ткани {полоски}
малиновка - птица семейства {птица}
манеры - кого-либо действия {кого-либо}
маслина - дерево семейства {дерево}
мастерство - уровень владения {уровень}
матрас","матрац - Предмет быта {Предмет}
мгновение","мгновенье - Промежуток времени {Промежуток}
мебель - Совокупность предметов {Совокупность}
мелодия - последовательность звуков {последовательность}
мессия - Объект поклонения {Объект}
месть - причинение зла {причинение}
мир - Совокупность всего {Совокупность}
мировоззрение - Система представлений {Система}
миска - Предмет посуды {Предмет}
молодость - Период жизни {Период}
монастырь - Комплекс сооружений {Комплекс}
мораль - Система норм {Система}
мораль - Совокупность принципов {Совокупность}
мусульманин - Приверженец мусульманства {Приверженец}
мученичество - Состояние мученика {Состояние}
набор - Совокупность предметов {Совокупность}
наводнение - затопление местности {затопление}
надежда - Ожидание чего-либо {Ожидание}
надрыв - Состояние угнетенности {Состояние}
наказание - Мера воздействия {Мера}
наказание - Мера воздействия {Мера}
накал - степень напряжения {степень}
напряжённность - протекание эмоций {протекание}
нарыв - воспаление ткани {воспаление}
наслаждение - степень удовольствия {степень}
наука - Область деятельности {Область}
неблагородство - Отсутствие благородства {Отсутствие}
невиновный - собой вины {собой}
негодяй - отношении человек {отношении}
неделя - Единица исчисления {Единица}
недовольство - Чувство неудовлетворения {Чувство}
нежелание - Отсутствие стремления {Отсутствие}
независимость - Отсутствие подчинения {Отсутствие}
независимость - Отсутствие подчиненности {Отсутствие}
независимость - Отсутствие подчинённости {Отсутствие}
незначительный - количеству размерам {количеству}
неистовость - Качество человека {Качество}
ненужный - нужды необходимости {нужды}
необходимость - Состояние кого-либо {Состояние}
неудача - стечение обстоятельств {стечение}
нечуткость - Отсутствие деликатности {Отсутствие}
обезболивание - Снятие боли {Снятие}
обломок - кусок чего-либо {кусок}
обмолот - Процесс выбивания {Процесс}
обобщение - изложение сути {изложение}
обособленность - Ограниченность связей {Ограниченность}
образ - отражение действительности {отражение}
образование - Процесс получения {Процесс}
общество - Совокупность людей {Совокупность}
общность - содержание чего-либо {содержание}
объединение - Совокупность лиц {Совокупность}
обычаи - Уклад жизни {Уклад}
обязанность - круг действий {круг}
огорчение - Чувство горечи {Чувство}
огорчение - Чувство печали {Чувство}
одежда - Совокупность предметов {Совокупность}
одиночество - состояние человека {состояние}
одобрение - Признание кого {Признание}
ожесточение","ожесточенье - Чувство ненависти {Чувство}
оковы - свободу действий {свободу}
окрестность - местность пространство {местность}
олицетворение - Представление чего-либо {Представление}
определение - член предложения {член}
определение - Процесс установления {Процесс}
осмеивание","осмеиванье - Представление кого {Представление}
останки - Тело человека {Тело}
остатки - разрушения гибели {разрушения}
остроумие - Изощрённость мысли {Изощрённость}
осуществление - Воплощение чего-либо {Воплощение}
ответвление - Стебель растения {Стебель}
отвращение - чувство брезгливости {чувство}
откровенность - Отсутствие скрытности {Отсутствие}
отчуждение - Отсутствие близости {Отсутствие}
официант - Работник предприятия {Работник}
очерёдность - последовательность чего-либо {последовательность}
падаль - Труп животного {Труп}
палец - частей руки {частей}
паротит - заболевание желез {заболевание}
перерыв - Период времени {Период}
перерыв - Период времени {Период}
перина - Предмет быта {Предмет}
петух - птица отряда {птица}
печаль - Чувство скорби {Чувство}
платок - Предмет одежды {Предмет}
плач - Выражение эмоций {Выражение}
повар - Работник предприятия {Работник}
подарок - знак внимания {знак}
подделка - подобие другого {подобие}
подсчитывание - Определение количества {Определение}
показ - Представление чего-либо {Представление}
показание - сообщение сведений {сообщение}
покрывало - Предмет быта {Предмет}
половик - Предмет быта {Предмет}
половодье - Выход водоёма {Выход}
положение - Совокупность факторов {Совокупность}
полугодие - Промежуток времени {Промежуток}
помидор - растение семейства {растение}
поражение - Выведение противника {Выведение}
порция - количество пищи {количество}
поступок - проявление деятельности {проявление}
правильность - Соответствие действительности {Соответствие}
предчувствие - чувство ожидания {чувство}
преемственность - Переход чего-либо {Переход}
прейскурант - Справочник цен {Справочник}
преобразование - изменения структуры {изменения}
пресмыкающееся - Животное класса {Животное}
приближение - Усиление чего-либо {Усиление}
приговор - Решение суда {Решение}
признание - изложение чего-либо {изложение}
припев - Слова песни {Слова}
приступ - Момент обострения {Момент}
присутствие - Существование кого {Существование}
приток - подъём уровня {подъём}
причёска - Порядок расположения {Порядок}
проверка - Установление соответствия {Установление}
продукты - Предметы питания {Предметы}
прокурор - лицо органов {лицо}
промышленность - Сфера разработки {Сфера}
протоиерей - Священнослужитель 2-й {Священнослужитель}
пук - прядь волос {прядь}
пустословие - речи разговоры {речи}
путаница - Отсутствие ясности {Отсутствие}
пятёрка - Отметка успеваемости {Отметка}
работа - Круг занятий {Круг}
равнодушие - отсутствие участия {отсутствие}
развалины - Остатки построек {Остатки}
разграничение - Разделение чего-либо {Разделение}
раздумье - Состояние погружённости {Состояние}
разлад - Отсутствие согласия {Отсутствие}
разновидность - явления типа {явления}
разногласие - Отсутствие согласия {Отсутствие}
разоружение - Комплекс мероприятий {Комплекс}
разрешение - Акт утверждения {Акт}
разум - деятельность человека {деятельность}
раскаяние - Чувство вины {Чувство}
растерянность - Состояние замешательства {Состояние}
растительность - Совокупность растений {Совокупность}
расшифровка - Раскрытие системы {Раскрытие}
реалистичность - Соответствие действительности {Соответствие}
регистрация - Запись лиц {Запись}
режиссура - Организация съёмок {Организация}
репейник - растение семейства {растение}
росток - Стебель растения {Стебель}
ругань - оскорбления ругательства {оскорбления}
рукавицы - Предмет одежды {Предмет}
румянец - цвет щёк {цвет}
самокат - Средство передвижения {Средство}
свержение - Процесс лишения {Процесс}
свобода - Отсутствие зависимости {Отсутствие}
свободомыслие - Образ мыслей {Образ}
сезон - Период времени {Период}
сила - значимость кого {значимость}
скамья - Предмет мебели {Предмет}
скульптура - Искусство создания {Искусство}
славяноведение - Совокупность наук {Совокупность}
смелость - Отсутствие страха {Отсутствие}
смерть - Прекращение жизни {Прекращение}
смешки - слова шутки {слова}
собака - животное семейства {животное}
собрание - присутствие членов {присутствие}
согласие","согласье - Взаимодействие людей {Взаимодействие}
согласованность - строение частей {строение}
сознание","сознанье - деятельность человека {деятельность}
сомнение","сомненье - Состояние неуверенности {Состояние}
сообразительность - Способность человека {Способность}
сплетни - Распространение известий {Распространение}
сравнение - Уподобление кого {Уподобление}
срок - промежуток времени {промежуток}
срочность - Необходимость совершения {Необходимость}
стадо - Группа животных {Группа}
старость - Период жизни {Период}
статуя - Произведение искусства {Произведение}
стая - Группа птиц {Группа}
стая - Группа собак {Группа}
стиль - Совокупность особенностей {Совокупность}
стойкость - Качество характера {Качество}
столкновение - Встреча противников {Встреча}
стрельба - Ведение огня {Ведение}
строительство - Отрасль производства {Отрасль}
суд - Процесс разбирательства {Процесс}
судно - Средство передвижения {Средство}
судорога - сокращение мышц {сокращение}
судорога - сокращение мышц {сокращение}
судостроение - Отрасль промышленности {Отрасль}
судьба - путь кого-либо {путь}
судьба - воли человека {воли}
сумасшествие - Потеря рассудка {Потеря}
сфера - Совокупность фактов {Совокупность}
сценарист - Автор сценария {Автор}
сырость - Наличие воды {Наличие}
тело - Организм человека {Организм}
тишина - Отсутствие звуков {Отсутствие}
толпа - Скопление людей {Скопление}
тон - Характер звучания {Характер}
тост - пожелание чего-либо {пожелание}
трава - покров земли {покров}
трансляция - Процесс распространения {Процесс}
тройка - Отметка успеваемости {Отметка}
труп - тело человека {тело}
трусливость - Чувство страха {Чувство}
туловище - Тело человека {Тело}
турне - Поездка артистов {Поездка}
тюрьма - Место заключения {Место}
удовольствие - Чувство удовлетворения {Чувство}
улыбка - Движение мышц {Движение}
ум - Способность человека {Способность}
уныние - состояние духа {состояние}
упряжь - Совокупность приспособлений {Совокупность}
усталость - Состояние утомления {Состояние}
устройство - Расположение частей {Расположение}
устье - Место впадения {Место}
учебник - Средство обучения {Средство}
фартук - Предмет одежды {Предмет}
фильм - Произведение киноискусства {Произведение}
форма - очертания предмета {очертания}
фотография - Произведение искусства {Произведение}
фраза - Отрезок речи {Отрезок}
ход - изменения кого {изменения}
холод - Состояние атмосферы {Состояние}
цвет - тон чего-либо {тон}
цель - Предмет стремления {Предмет}
цена - выражение труда {выражение}
центр - Точка пересечения {Точка}
цыплёнок - Птенец курицы {Птенец}
частица - количество чего-либо {количество}
четвёрка - Отметка успеваемости {Отметка}
чибис - птица семейства {птица}
чувство - состояние человека {состояние}
шарф - Предмет одежды {Предмет}
швейцар - Работник гостиницы {Работник}
швея - шитьём одежды {шитьём}
штанина - частей штанов {частей}
шутовство - Поведение шута {Поведение}
щёки - части лица {части}
эквилибрист - Артист цирка {Артист}
экзамен - проверки знаний {проверки}
экономика - Совокупность средств {Совокупность}
электролиния - Система электропроводов {Система}
юрок - птица отряда {птица}
